anno_acc,anno_sol,id_ateneo,ateneo_breve,imm_maschi,imm_femmine,imm_fs,imm_nfs,imm_totali_s,imm_totali,isc_maschi,isc_femmine,isc_1anno,isc_fs,isc_nfs,isc_totali,lau_maschi,lau_femmine,lau_totali
2018/2019,2019,00101,Torino,4953,7999,1901,10680,808,12952,28294,44604,20992,14592,57077,72898,5370,8537,13907
2018/2019,2019,00102,Torino Politecnico,3567,1466,2202,2621,570,5033,23148,9112,10847,17047,14776,32260,5238,2255,7493
2018/2019,2019,00201,Piemonte Orientale,1240,2040,862,2156,229,3280,4913,7734,4092,3284,8827,12647,824,1539,2363
2018/2019,2019,00401,Scienze Gastronomiche,43,34,28,13,30,77,192,168,130,79,119,360,59,44,103
2018/2019,2019,00701,Aosta,67,153,55,125,24,220,316,709,314,273,615,1025,59,207,266
2018/2019,2019,01001,Genova,2599,3024,534,4788,535,5623,13521,16750,8939,3927,24974,30271,2474,3320,5794
2018/2019,2019,01201,LIUC,258,143,22,275,9,401,1491,794,887,183,1502,2285,436,226,662
2018/2019,2019,01202,Insubria,1267,1681,107,2708,170,2948,4875,5828,3519,505,9826,10703,746,1123,1869
2018/2019,2019,01301,Novedrate,1266,1171,1778,425,124,2437,7629,7994,6669,12783,2509,15623,1261,1484,2745
2018/2019,2019,01501,Milano,4324,6312,1543,8706,683,10636,24681,34731,17190,11329,47610,59412,4684,7192,11876
2018/2019,2019,01502,Milano Politecnico,5260,2550,2499,4992,367,7810,29789,14857,14663,18727,25895,44646,7838,4450,12288
2018/2019,2019,01503,Milano Bocconi,1664,1073,1640,869,517,2737,7763,5763,4706,9413,4034,13526,2551,2168,4719
2018/2019,2019,01504,Milano Cattolica,2662,5123,2382,4834,530,7785,13714,26148,12858,16679,23072,39862,3542,6790,10332
2018/2019,2019,01505,IULM,440,1181,303,1004,77,1621,1797,4454,2323,1916,3644,6251,398,1090,1488
2018/2019,2019,01508,Milano San Raffaele,197,291,89,197,40,488,1088,1722,888,685,1397,2810,226,419,645
2018/2019,2019,01509,Milano Bicocca,2161,3244,329,4714,275,5405,12880,20256,9609,3791,28003,33136,2632,4460,7092
2018/2019,2019,01510,Humanitas University,58,161,82,69,88,219,337,608,272,194,490,945,36,51,87
2018/2019,2019,01601,Bergamo,1628,2664,32,4134,280,4292,7411,12039,6409,258,18060,19450,1389,2481,3870
2018/2019,2019,01701,Brescia,1574,1247,103,2595,202,2821,7588,6374,3836,595,12999,13962,1390,1192,2582
2018/2019,2019,01801,Pavia,2184,2697,1282,3371,435,4881,10304,12794,7294,7424,14833,23098,1993,2587,4580
2018/2019,2019,02101,Bolzano,178,460,246,303,57,638,1199,2560,945,1348,1995,3759,235,470,705
2018/2019,2019,02201,Trento,1489,1453,1678,998,79,2942,8154,8370,4788,9857,5840,16524,1782,1919,3701
2018/2019,2019,02301,Verona,1362,2679,1169,2647,179,4041,8121,14632,6622,6594,15109,22753,1731,3394,5125
2018/2019,2019,02701,Ca Foscari,1438,2767,637,3260,258,4205,7428,13359,6942,5157,14990,20787,1649,3381,5030
2018/2019,2019,02702,IUAV,266,371,72,473,56,637,1813,2145,1301,496,2677,3958,534,659,1193
2018/2019,2019,02801,Padova,5166,5558,1504,8804,428,10724,27656,30984,17154,12388,46026,58640,5953,7391,13344
2018/2019,2019,03001,Udine,1450,1580,673,2200,158,3030,7115,7739,4591,3261,10820,14854,1412,1732,3144
2018/2019,2019,03201,Trieste,1086,1654,742,1666,154,2740,6677,8639,4304,4832,9087,15316,1250,1753,3003
2018/2019,2019,03401,Parma,2137,2981,2079,2806,334,5118,11029,14729,7961,12238,13183,25758,2212,2947,5159
2018/2019,2019,03601,Modena e Reggio Emilia,2464,2746,810,3865,290,5210,11680,13264,8235,6605,17451,24944,2246,2858,5104
2018/2019,2019,03701,Bologna,6019,7680,5021,8061,1282,13699,35371,44708,23108,37562,42517,80079,8148,10877,19025
2018/2019,2019,03801,Ferrara,2419,4043,4269,1985,251,6462,8505,11811,7387,12581,7673,20316,1386,1772,3158
2018/2019,2019,04101,Carlo Bo,1084,1679,1159,1401,147,2763,5405,8820,4034,6968,6860,14225,997,1797,2794
2018/2019,2019,04201,Marche,1600,1212,625,2064,114,2812,8288,6718,4195,3586,10957,15006,1544,1415,2959
2018/2019,2019,04301,Macerata,434,1312,223,1402,88,1746,2760,7438,3237,1916,7574,10198,515,1506,2021
2018/2019,2019,04302,Camerino,657,639,251,833,103,1296,3414,3390,1826,2445,3761,6804,431,490,921
2018/2019,2019,04801,Firenze,3588,4640,1129,6856,646,8228,21790,29861,14480,11790,39843,51651,3448,5536,8984
2018/2019,2019,04804,IUL,9,33,NA,NA,1,42,73,201,137,NA,NA,274,9,37,46
2018/2019,2019,05001,Pisa,3504,3639,1733,5122,333,7143,21642,22724,12156,13750,29877,44366,3752,3992,7744
2018/2019,2019,05201,Siena,951,1511,706,1447,188,2462,6430,9290,4074,6420,7728,15720,1205,1818,3023
2018/2019,2019,05202,Siena Stranieri,82,457,101,271,55,539,385,1768,705,623,1139,2153,66,350,416
2018/2019,2019,05401,Perugia,1963,2467,976,3161,306,4430,10101,13392,7110,7402,15341,23493,1836,2697,4533
2018/2019,2019,05403,Perugia Stranieri,76,117,41,123,78,193,380,671,443,195,591,1051,73,189,262
2018/2019,2019,05601,Tuscia,678,733,160,1108,52,1411,3900,3859,2335,1342,5856,7759,899,704,1603
2018/2019,2019,05801,La Sapienza,7024,9736,2139,14256,1091,16760,43573,58426,28802,18207,82587,101999,7680,11191,18871
2018/2019,2019,05802,Tor Vergata,2310,2369,507,3999,409,4679,13251,14467,8548,4699,21858,27718,3058,3115,6173
2018/2019,2019,05803,Roma LUMSA,292,642,244,545,36,934,1756,3984,1739,1708,3121,5740,381,973,1354
2018/2019,2019,05805,Roma LUISS,914,785,612,863,51,1699,5070,4217,2945,4252,4459,9287,1512,1235,2747
2018/2019,2019,05806,Roma Foro Italico,260,91,NA,288,3,351,1576,555,691,NA,1701,2131,365,171,536
2018/2019,2019,05807,Roma Tre,2419,3080,353,4863,297,5499,12700,18490,8785,2754,26962,31190,2278,3537,5815
2018/2019,2019,05808,Campus Biomedico,132,205,13,195,4,337,710,1132,552,190,1051,1842,175,270,445
2018/2019,2019,05809,Roma UNINT,33,125,NA,95,8,158,333,1206,800,NA,941,1539,98,369,467
2018/2019,2019,05810,Roma Marconi,389,454,347,163,41,843,4758,4871,3629,5737,2263,9629,806,815,1621
2018/2019,2019,05811,Unitelma,107,93,12,67,15,200,915,834,740,211,725,1749,165,154,319
2018/2019,2019,05812,Roma Europea,69,159,18,180,9,228,388,850,371,106,976,1238,72,149,221
2018/2019,2019,05813,Uninettuno,671,498,726,146,161,1169,7917,5268,2695,9566,3087,13185,241,190,431
2018/2019,2019,05814,Mercatorum,1,NA,NA,NA,NA,NA,2554,890,1641,NA,NA,3444,545,130,675
2018/2019,2019,05815,Unicusano,1072,384,866,278,22,1456,14278,9941,6367,17452,5218,24219,557,446,1003
2018/2019,2019,05816,Roma San Raffaele,401,222,161,149,12,623,3095,2373,3189,2133,1286,5468,412,426,838
2018/2019,2019,05817,Link Campus,214,73,57,79,19,287,1375,471,419,511,596,1846,329,118,447
2018/2019,2019,06001,Cassino,642,648,372,858,97,1290,3338,3911,2175,2099,4991,7249,701,825,1526
2018/2019,2019,06201,Sannio,419,412,17,790,10,831,2246,2389,1137,83,4413,4635,434,443,877
2018/2019,2019,06202,Benevento - Giustino Fortunato,55,42,NA,30,2,97,547,389,539,NA,528,936,213,120,333
2018/2019,2019,06301,Napoli Federico II,6225,7377,410,13007,119,13602,33574,41090,20424,2952,71057,74664,5832,7385,13217
2018/2019,2019,06302,Napoli Parthenope,1079,719,NA,1727,17,1798,6460,4884,2881,NA,10913,11344,1250,1035,2285
2018/2019,2019,06303,Napoli L'Orientale,447,1840,168,1986,94,2287,2362,9221,3358,1242,9940,11583,328,1540,1868
2018/2019,2019,06304,Benincasa,194,1073,NA,1219,4,1267,1206,7017,2385,NA,7844,8223,243,1531,1774
2018/2019,2019,06306,Napoli II,1466,1909,77,3205,100,3375,9941,13996,5786,406,22709,23937,1902,2989,4891
2018/2019,2019,06307,Napoli Pegaso,3512,2327,4085,1560,170,5839,23244,16552,18782,26605,12902,39796,5331,3852,9183
2018/2019,2019,06501,Salerno,2815,3149,201,5701,78,5964,15426,19922,8786,1574,33306,35348,2573,3476,6049
2018/2019,2019,06601,Aquila,925,942,493,1237,51,1867,7020,8890,3865,5377,9200,15910,1373,1823,3196
2018/2019,2019,06701,Teramo,448,480,110,673,27,928,2393,3126,1316,924,3973,5519,435,565,1000
2018/2019,2019,06901,Chieti e Pescara,1370,2368,1421,2101,96,3738,8574,15094,6221,9806,13126,23668,1659,3480,5139
2018/2019,2019,06902,Torrevecchia Teatina,1,1,NA,NA,NA,2,30,41,NA,NA,NA,71,6,8,14
2018/2019,2019,07001,Molise,500,573,356,625,31,1073,2823,3991,1737,2929,3691,6814,468,747,1215
2018/2019,2019,07101,Foggia,782,1166,110,1742,35,1948,3929,6427,2853,726,9412,10356,661,1200,1861
2018/2019,2019,07201,Bari,2976,4331,359,6807,127,7307,15978,26716,10669,2596,39349,42694,2710,4766,7476
2018/2019,2019,07202,Bari Politecnico,1337,541,86,1774,20,1878,6805,3009,2552,412,9273,9814,1313,677,1990
2018/2019,2019,07203,Jean Monnet,146,83,NA,206,NA,229,900,597,340,NA,1422,1497,215,150,365
2018/2019,2019,07501,Salento,1405,1972,28,3284,32,3377,6435,10581,5015,208,16587,17016,1104,2005,3109
2018/2019,2019,07601,Basilicata,445,481,167,703,8,926,2704,3706,1451,1536,4815,6410,366,536,902
2018/2019,2019,07801,Calabria,1787,2267,256,3761,144,4054,10674,14591,5707,1289,23777,25265,1821,2648,4469
2018/2019,2019,07901,Catanzaro,695,1045,37,1647,37,1740,4165,6613,2408,205,9879,10778,574,976,1550
2018/2019,2019,08001,Reggio Calabria,389,314,32,652,23,703,2444,2491,1168,363,4510,4935,375,359,734
2018/2019,2019,08003,Reggio Calabria - Dante Alighieri,24,78,15,75,25,102,140,640,226,97,624,780,25,142,167
2018/2019,2019,08201,Palermo,3130,4041,34,7097,88,7171,16586,22883,10854,216,38983,39469,3020,4433,7453
2018/2019,2019,08301,Messina,1397,2277,727,2908,96,3674,8352,14099,5667,5093,17075,22451,1458,2420,3878
2018/2019,2019,08601,Enna,255,438,NA,686,3,693,1662,3158,1079,NA,4766,4820,346,785,1131
2018/2019,2019,08701,Catania,2802,3267,10,5983,44,6069,16855,22611,9096,85,39076,39466,2439,3823,6262
2018/2019,2019,09001,Sassari,872,1296,15,2082,57,2168,4892,8349,3749,95,12630,13241,762,1448,2210
2018/2019,2019,09201,Cagliari,1782,2130,13,3854,63,3912,10270,14572,6306,130,24418,24842,1537,2465,4002
2017/2018,2018,00101,Torino,5280,8082,1965,11022,1074,13362,28062,43523,21414,14098,56761,71585,4924,8066,12990
2017/2018,2018,00102,Torino Politecnico,3671,1415,2316,2561,602,5086,22875,8951,10114,16792,14691,31826,5025,2218,7243
2017/2018,2018,00201,Piemonte Orientale,1176,1919,869,1990,205,3095,4745,7386,3709,3161,8577,12131,759,1265,2024
2017/2018,2018,00401,Scienze Gastronomiche,37,41,28,11,37,78,179,161,133,72,119,340,54,64,118
2017/2018,2018,00701,Aosta,74,159,36,126,15,233,301,750,297,259,631,1051,57,168,225
2017/2018,2018,01001,Genova,2451,2991,485,4664,522,5442,14515,17482,8807,4554,26527,31997,2605,3429,6034
2017/2018,2018,01201,LIUC,221,129,22,253,8,350,1365,745,738,167,1372,2110,453,287,740
2017/2018,2018,01202,Insubria,1314,1463,97,2589,145,2777,4645,5400,3248,453,9262,10045,726,1037,1763
2017/2018,2018,01301,Novedrate,837,780,974,317,95,1617,5679,5703,4204,8892,2012,11382,1000,1180,2180
2017/2018,2018,01501,Milano,4533,6601,1590,9189,626,11134,25373,35222,17665,10902,49259,60595,4506,7137,11643
2017/2018,2018,01502,Milano Politecnico,5183,2399,2345,4854,409,7582,29162,14511,14350,17895,25714,43673,7338,4419,11757
2017/2018,2018,01503,Milano Bocconi,1608,1099,1641,833,400,2707,7520,5906,4647,9336,4021,13426,2426,2121,4547
2017/2018,2018,01504,Milano Cattolica,2615,5276,2465,4852,535,7891,13449,25032,12561,15689,22437,38481,3479,6473,9952
2017/2018,2018,01505,IULM,422,1073,219,967,58,1495,1670,4062,2147,1789,3363,5732,374,1049,1423
2017/2018,2018,01508,Milano San Raffaele,121,245,28,157,29,366,1024,1578,759,120,1277,2602,228,357,585
2017/2018,2018,01509,Milano Bicocca,2257,3446,322,4924,337,5703,12941,20226,9562,3268,28156,33167,2588,4485,7073
2017/2018,2018,01510,Humanitas University,81,127,68,73,78,208,286,435,245,148,379,721,3,19,22
2017/2018,2018,01601,Bergamo,1511,2454,21,3832,261,3965,6953,11142,5748,199,16913,18095,1155,2374,3529
2017/2018,2018,01701,Brescia,1489,1257,111,2524,210,2746,7559,6403,3703,572,13009,13962,1308,1196,2504
2017/2018,2018,01801,Pavia,2094,2746,1350,3265,380,4840,9828,12170,6741,7325,14193,21998,1896,2572,4468
2017/2018,2018,02101,Bolzano,211,580,276,401,90,791,1179,2502,1074,1289,1995,3681,216,487,703
2017/2018,2018,02201,Trento,1447,1499,1645,1036,64,2946,8066,8186,4683,9330,5912,16252,1804,1899,3703
2017/2018,2018,02301,Verona,1570,3064,1371,3032,236,4634,8346,15119,7242,7080,15669,23465,1603,3281,4884
2017/2018,2018,02701,Ca Foscari,1471,2627,609,3142,240,4098,7223,13103,6777,5021,14651,20326,1659,3591,5250
2017/2018,2018,02702,IUAV,270,378,86,469,47,648,1887,2107,1277,640,2734,3994,602,650,1252
2017/2018,2018,02801,Padova,5304,5719,1478,9152,454,11023,27229,30673,16981,11379,45973,57902,5744,6923,12667
2017/2018,2018,03001,Udine,1374,1465,525,2178,160,2839,7189,7715,4216,3363,10937,14904,1372,1568,2940
2017/2018,2018,03201,Trieste,1183,1630,840,1655,237,2813,6693,8438,4239,4784,9117,15131,1245,1718,2963
2017/2018,2018,03401,Parma,2108,2898,2094,2647,408,5006,10803,13992,7553,11721,12758,24795,1892,2657,4549
2017/2018,2018,03601,Modena e Reggio Emilia,2646,2617,1018,3749,328,5263,11231,12526,8116,6134,16963,23757,2122,2517,4639
2017/2018,2018,03701,Bologna,6137,7601,5170,7914,1261,13738,35396,44113,22658,36804,42704,79509,7926,10313,18239
2017/2018,2018,03801,Ferrara,2096,3657,3566,1957,304,5753,7847,10553,6973,10895,7411,18400,1279,1800,3079
2017/2018,2018,04101,Carlo Bo,1051,1702,1160,1364,158,2753,5413,8709,3959,6552,6668,14122,972,1653,2625
2017/2018,2018,04201,Marche,1519,1166,518,1995,117,2685,8345,6857,4184,3486,11151,15202,1557,1487,3044
2017/2018,2018,04301,Macerata,428,1259,258,1288,61,1687,2771,7271,3055,1867,7366,10042,461,1473,1934
2017/2018,2018,04302,Camerino,587,546,198,706,117,1133,3386,3398,1870,1892,3689,6784,454,498,952
2017/2018,2018,04801,Firenze,3886,5043,1492,7237,683,8929,21374,30305,13982,11432,40233,51679,3501,5404,8905
2017/2018,2018,04804,IUL,4,27,NA,NA,1,31,65,160,95,NA,NA,225,9,35,44
2017/2018,2018,05001,Pisa,3579,3519,1622,5140,350,7098,21638,22668,11199,13366,29831,44306,3500,3898,7398
2017/2018,2018,05201,Siena,1005,1478,842,1324,240,2483,6591,9148,4217,6904,7545,15739,1174,1761,2935
2017/2018,2018,05202,Siena Stranieri,114,469,159,268,83,583,401,1668,708,708,1083,2069,68,323,391
2017/2018,2018,05401,Perugia,1772,2329,964,2842,264,4101,9879,13105,6615,7252,14871,22984,1740,2568,4308
2017/2018,2018,05403,Perugia Stranieri,45,74,10,86,39,119,321,614,371,155,538,935,72,140,212
2017/2018,2018,05601,Tuscia,830,777,210,1225,55,1607,4147,3952,2365,1290,6114,8099,804,802,1606
2017/2018,2018,05801,La Sapienza,6944,9272,2044,13832,1036,16216,43040,57351,27596,17874,80654,100391,7307,10598,17905
2017/2018,2018,05802,Tor Vergata,2254,2499,434,4088,431,4753,13791,14704,8502,4791,22378,28495,2863,3084,5947
2017/2018,2018,05803,Roma LUMSA,287,560,221,465,34,847,1746,3896,1521,2200,3012,5642,374,1020,1394
2017/2018,2018,05805,Roma LUISS,901,761,568,868,17,1662,4901,4143,2928,4003,4361,9044,1406,1206,2612
2017/2018,2018,05806,Roma Foro Italico,268,73,NA,279,5,341,1602,572,682,NA,1775,2174,340,153,493
2017/2018,2018,05807,Roma Tre,2457,3290,357,5109,320,5747,13085,18866,9084,3075,27636,31951,2394,3538,5932
2017/2018,2018,05808,Campus Biomedico,105,205,NA,186,2,310,693,1088,532,NA,985,1781,171,269,440
2017/2018,2018,05809,Roma UNINT,17,113,NA,92,5,130,298,1005,535,NA,805,1303,92,435,527
2017/2018,2018,05810,Roma Marconi,389,364,295,133,29,753,4758,4407,3242,5536,2178,9165,803,777,1580
2017/2018,2018,05811,Unitelma,106,99,35,62,6,205,853,787,680,241,654,1640,200,165,365
2017/2018,2018,05812,Roma Europea,74,138,NA,160,6,212,337,667,366,NA,812,1004,82,91,173
2017/2018,2018,05813,Uninettuno,468,342,356,134,67,810,6982,4534,1992,7108,2896,11516,312,221,533
2017/2018,2018,05814,Mercatorum,4,NA,NA,NA,NA,NA,1543,394,969,NA,NA,1937,55,25,80
2017/2018,2018,05815,Unicusano,1496,817,1506,548,47,2313,12960,8720,7516,16517,4712,21680,2113,1476,3589
2017/2018,2018,05816,Roma San Raffaele,354,176,131,124,8,530,2398,1837,1947,1857,983,4235,302,283,585
2017/2018,2018,05817,Link Campus,260,61,44,85,12,321,1352,525,400,527,682,1877,302,148,450
2017/2018,2018,06001,Cassino,550,582,313,787,53,1132,3346,3885,2042,2058,5052,7231,596,840,1436
2017/2018,2018,06201,Sannio,438,424,20,807,14,862,2349,2490,1157,82,4607,4839,393,509,902
2017/2018,2018,06202,Benevento - Giustino Fortunato,46,12,NA,NA,NA,58,538,278,416,NA,NA,816,178,106,284
2017/2018,2018,06301,Napoli Federico II,5823,6750,370,12047,92,12573,33787,41473,19248,2782,71778,75260,5865,7458,13323
2017/2018,2018,06302,Napoli Parthenope,1136,721,11,1772,16,1857,6861,5220,2829,60,11609,12081,1194,1011,2205
2017/2018,2018,06303,Napoli L'Orientale,430,1610,136,1770,105,2040,2377,8843,3078,1022,9652,11220,370,1500,1870
2017/2018,2018,06304,Benincasa,207,1167,10,1327,9,1374,1206,7025,2429,79,7845,8231,213,1542,1755
2017/2018,2018,06306,Napoli II,1494,1813,52,3129,80,3307,10407,14345,5624,119,23531,24752,1827,2616,4443
2017/2018,2018,06307,Napoli Pegaso,2402,862,2001,1029,10,3264,18116,11718,15978,18426,10787,29834,3854,2671,6525
2017/2018,2018,06501,Salerno,2761,3030,190,5528,64,5791,15363,20225,8402,1580,33541,35588,2307,3117,5424
2017/2018,2018,06601,Aquila,913,929,463,1212,54,1842,7088,9123,3778,5134,9395,16211,1231,1828,3059
2017/2018,2018,06701,Teramo,417,513,88,676,14,930,2506,3352,1416,980,4261,5858,402,575,977
2017/2018,2018,06901,Chieti e Pescara,1466,2466,1485,2240,118,3932,8800,15401,6286,10172,13363,24201,1595,3193,4788
2017/2018,2018,06902,Torrevecchia Teatina,2,NA,NA,NA,NA,NA,45,54,15,NA,NA,99,4,9,13
2017/2018,2018,07001,Molise,463,594,369,599,21,1057,2797,4097,1678,3017,3702,6894,412,604,1016
2017/2018,2018,07101,Foggia,817,1257,110,1863,28,2074,3860,6334,3007,693,9305,10194,645,1034,1679
2017/2018,2018,07201,Bari,2887,4339,361,6724,150,7226,16224,27024,10464,2648,39845,43248,2808,4761,7569
2017/2018,2018,07202,Bari Politecnico,1241,529,66,1684,24,1770,6712,3045,2516,399,9244,9757,1272,644,1916
2017/2018,2018,07203,Jean Monnet,154,94,NA,230,1,248,948,601,380,NA,1450,1549,209,128,337
2017/2018,2018,07501,Salento,1275,1895,25,3109,42,3170,6214,10412,4806,221,16189,16626,1072,2067,3139
2017/2018,2018,07601,Basilicata,479,495,186,741,12,974,2809,3763,1369,1545,4956,6572,376,574,950
2017/2018,2018,07801,Calabria,1802,2148,242,3670,159,3950,10938,15051,5907,1071,24539,25989,1663,2536,4199
2017/2018,2018,07901,Catanzaro,745,1098,NA,1737,47,1843,4105,6296,2536,NA,9594,10401,568,880,1448
2017/2018,2018,08001,Reggio Calabria,369,263,24,585,13,632,2643,2628,1025,382,4820,5271,439,444,883
2017/2018,2018,08003,Reggio Calabria - Dante Alighieri,33,85,36,72,37,118,151,709,254,109,680,860,35,174,209
2017/2018,2018,08201,Palermo,3005,3792,25,6730,72,6797,16510,22801,10551,156,38866,39311,2737,4347,7084
2017/2018,2018,08301,Messina,1530,2428,897,3031,78,3958,8604,14334,5859,5416,17247,22938,1334,2572,3906
2017/2018,2018,08601,Enna,292,463,NA,745,7,755,1855,3326,1122,NA,5127,5181,428,712,1140
2017/2018,2018,08701,Catania,2846,3322,13,6090,40,6168,17651,24420,8831,107,41691,42071,2493,3701,6194
2017/2018,2018,09001,Sassari,842,1355,NA,2119,43,2197,4790,8328,3641,NA,12600,13118,752,1405,2157
2017/2018,2018,09201,Cagliari,1649,1949,NA,3554,40,3598,10387,14777,5665,NA,24788,25164,1623,2428,4051
2016/2017,2017,00101,Torino,4862,7638,1743,10441,843,12500,26606,41807,20072,11765,55255,68413,4744,7801,12545
2016/2017,2017,00102,Torino Politecnico,3685,1325,2411,2385,614,5010,22264,8742,9853,16006,14648,31006,4609,2075,6684
2016/2017,2017,00201,Piemonte Orientale,1306,2223,1171,2063,202,3529,4591,7152,4068,3089,8389,11743,659,1167,1826
2016/2017,2017,00401,Scienze Gastronomiche,42,33,23,19,29,75,166,153,101,66,113,319,52,53,105
2016/2017,2017,00701,Aosta,60,149,41,119,15,209,289,770,294,248,669,1059,70,187,257
2016/2017,2017,01001,Genova,2482,2976,518,4665,448,5458,14253,17227,8535,4600,25959,31480,2461,3309,5770
2016/2017,2017,01201,LIUC,222,121,28,227,9,343,1311,729,745,159,1274,2040,371,222,593
2016/2017,2017,01202,Insubria,1064,1186,86,2064,124,2250,4274,5058,2818,440,8572,9332,650,978,1628
2016/2017,2017,01301,Novedrate,532,531,562,191,80,1063,4579,4512,2709,6854,1646,9091,818,860,1678
2016/2017,2017,01501,Milano,4522,6689,1577,9302,670,11211,24797,34900,16793,10434,49061,59697,4323,7115,11438
2016/2017,2017,01502,Milano Politecnico,5185,2335,2153,4993,354,7520,28401,14037,14151,16274,25889,42438,6999,4038,11037
2016/2017,2017,01503,Milano Bocconi,1577,1196,1722,851,482,2773,7149,6121,4712,9269,3984,13270,2323,2184,4507
2016/2017,2017,01504,Milano Cattolica,2711,4988,2473,4672,557,7699,13238,23894,11951,15207,21738,37132,3402,6573,9975
2016/2017,2017,01505,IULM,367,977,217,796,54,1344,1502,3714,1959,1477,2957,5216,307,954,1261
2016/2017,2017,01508,Milano San Raffaele,170,268,29,198,20,438,996,1466,711,269,1231,2462,195,334,529
2016/2017,2017,01509,Milano Bicocca,2403,3470,392,5105,349,5873,12700,20022,9557,3619,27832,32722,2411,4286,6697
2016/2017,2017,01510,Humanitas University,81,96,71,51,81,177,209,312,200,101,283,521,3,13,16
2016/2017,2017,01601,Bergamo,1389,2265,27,3532,214,3654,6374,10428,5378,241,15838,16802,1048,2111,3159
2016/2017,2017,01701,Brescia,1501,1165,100,2455,183,2666,7511,6377,3670,544,12964,13888,1361,1272,2633
2016/2017,2017,01801,Pavia,1967,2425,1229,2900,310,4392,9537,11827,6465,6555,13867,21364,1894,2527,4421
2016/2017,2017,02101,Bolzano,176,487,229,342,78,663,1046,2247,890,1094,1872,3293,179,432,611
2016/2017,2017,02201,Trento,1433,1486,1580,1081,72,2919,8015,8139,4408,9039,6033,16154,1689,1838,3527
2016/2017,2017,02301,Verona,1599,3114,1442,3051,218,4713,8336,14775,7154,6928,15611,23111,1609,3203,4812
2016/2017,2017,02701,Ca Foscari,1275,2415,557,2786,201,3690,6970,12849,6266,3689,14512,19819,1530,3199,4729
2016/2017,2017,02702,IUAV,259,381,73,464,40,640,1985,2154,1333,486,2877,4139,592,703,1295
2016/2017,2017,02801,Padova,5376,5874,1439,9411,489,11250,26990,30860,17004,10221,46449,57850,5485,7216,12701
2016/2017,2017,03001,Udine,1494,1591,689,2242,198,3085,7263,7763,4552,3629,10864,15026,1248,1579,2827
2016/2017,2017,03201,Trieste,1153,1414,659,1597,204,2567,6574,8259,3949,4495,9149,14833,1178,1684,2862
2016/2017,2017,03401,Parma,2100,2644,1964,2499,329,4744,10492,13394,7252,10835,12548,23886,1975,2608,4583
2016/2017,2017,03601,Modena e Reggio Emilia,2246,2585,763,3583,285,4831,10426,11729,7368,5281,16279,22155,1780,2446,4226
2016/2017,2017,03701,Bologna,6334,7912,5309,8246,1086,14246,34990,43527,22999,35626,42890,78517,7589,10272,17861
2016/2017,2017,03801,Ferrara,1192,1570,1257,1266,179,2762,6961,8599,4059,8233,6688,15560,1283,1692,2975
2016/2017,2017,04101,Carlo Bo,1009,1671,1251,1208,159,2680,5364,8562,3884,6820,6476,13926,930,1640,2570
2016/2017,2017,04201,Marche,1477,1302,641,1976,119,2779,8329,6986,4129,3569,11286,15315,1551,1432,2983
2016/2017,2017,04301,Macerata,498,1330,437,1276,61,1828,2892,7289,3192,1858,7513,10181,480,1495,1975
2016/2017,2017,04302,Camerino,584,577,208,702,97,1161,3475,3468,1779,2104,3699,6943,497,523,1020
2016/2017,2017,04801,Firenze,3784,5067,1276,7296,661,8851,20975,30021,14033,10288,40391,50996,3293,4980,8273
2016/2017,2017,04804,IUL,10,28,13,NA,1,38,47,149,112,70,NA,196,NA,26,NA
2016/2017,2017,05001,Pisa,3937,3675,2092,5208,373,7612,21975,23239,12160,14014,30287,45214,3395,3678,7073
2016/2017,2017,05201,Siena,992,1409,925,1225,232,2401,6509,8954,4012,7004,7471,15463,1163,1622,2785
2016/2017,2017,05202,Siena Stranieri,111,469,147,296,63,580,349,1534,719,671,1035,1883,46,265,311
2016/2017,2017,05401,Perugia,2174,3034,1880,3057,260,5208,9919,13029,7587,7685,14795,22948,1759,2407,4166
2016/2017,2017,05403,Perugia Stranieri,41,75,12,83,52,116,330,551,313,182,486,881,79,138,217
2016/2017,2017,05601,Tuscia,832,804,221,1258,43,1636,4104,3904,2491,1576,6024,8008,744,594,1338
2016/2017,2017,05801,La Sapienza,7178,9499,2205,14142,1010,16677,42921,57565,27118,19356,79631,100486,7448,11025,18473
2016/2017,2017,05802,Tor Vergata,2464,2514,525,4239,399,4978,14419,15119,9326,5288,22669,29538,2888,3039,5927
2016/2017,2017,05803,Roma LUMSA,234,478,203,376,39,712,1767,3849,1298,1696,2919,5616,362,952,1314
2016/2017,2017,05805,Roma LUISS,886,752,575,813,22,1638,4685,3984,2918,4026,4108,8669,1279,1115,2394
2016/2017,2017,05806,Roma Foro Italico,271,77,NA,288,8,348,1611,582,655,NA,1780,2193,343,167,510
2016/2017,2017,05807,Roma Tre,2321,3065,256,4798,308,5386,13344,19071,8515,3205,27984,32415,2441,3887,6328
2016/2017,2017,05808,Campus Biomedico,100,176,NA,160,3,276,678,1005,491,NA,894,1683,148,258,406
2016/2017,2017,05809,Roma UNINT,32,94,NA,88,5,126,324,1028,438,NA,807,1352,89,353,442
2016/2017,2017,05810,Roma Marconi,376,391,290,181,31,767,5121,4317,3194,5732,2221,9438,765,694,1459
2016/2017,2017,05811,Unitelma,99,59,21,54,7,158,817,676,523,202,574,1493,176,134,310
2016/2017,2017,05812,Roma Europea,68,107,NA,133,7,175,314,526,297,NA,687,840,71,145,216
2016/2017,2017,05813,Uninettuno,386,260,245,111,42,646,6454,4066,1663,5287,2760,10520,301,189,490
2016/2017,2017,05814,Mercatorum,76,39,NA,26,4,115,505,221,458,NA,155,726,38,24,62
2016/2017,2017,05815,Unicusano,1439,778,1415,516,41,2217,12384,8223,7482,15775,4388,20607,1838,1435,3273
2016/2017,2017,05816,Roma San Raffaele,293,174,99,114,12,467,1743,1311,1500,1210,746,3054,192,140,332
2016/2017,2017,05817,Link Campus,203,72,81,86,6,275,1238,550,445,516,706,1788,295,149,444
2016/2017,2017,06001,Cassino,577,587,302,830,24,1164,3495,4099,1974,1983,5345,7594,558,722,1280
2016/2017,2017,06201,Sannio,431,445,24,832,9,876,2497,2671,1185,171,4923,5168,398,465,863
2016/2017,2017,06202,Benevento - Giustino Fortunato,41,19,NA,12,NA,60,497,283,390,NA,441,780,148,92,240
2016/2017,2017,06301,Napoli Federico II,5797,6439,357,11734,108,12236,34356,42457,18665,2765,73354,76813,5650,7345,12995
2016/2017,2017,06302,Napoli Parthenope,1274,815,NA,2012,19,2089,7344,5625,3150,NA,12448,12969,1273,1024,2297
2016/2017,2017,06303,Napoli L'Orientale,429,1720,154,1870,92,2149,2376,8575,3120,1049,9433,10951,346,1563,1909
2016/2017,2017,06304,Benincasa,223,1141,NA,1317,17,1364,1174,6980,2276,NA,7776,8154,227,1548,1775
2016/2017,2017,06306,Napoli II,1591,1970,51,3406,51,3561,10608,14799,5981,312,24331,25407,1863,2848,4711
2016/2017,2017,06307,Napoli Pegaso,2187,1061,2018,975,13,3248,12879,7353,10601,11595,8037,20232,2497,1651,4148
2016/2017,2017,06501,Salerno,2916,3132,225,5768,60,6048,14932,20427,8564,1600,33326,35359,2029,3231,5260
2016/2017,2017,06601,Aquila,938,967,518,1244,58,1905,7429,9612,3904,6055,9729,17041,1449,2023,3472
2016/2017,2017,06701,Teramo,432,595,151,730,20,1027,2566,3537,1515,1122,4469,6103,420,602,1022
2016/2017,2017,06901,Chieti e Pescara,1569,2626,1665,2344,104,4195,9069,15874,6494,10750,13652,24943,1582,3395,4977
2016/2017,2017,06902,Torrevecchia Teatina,1,6,NA,NA,NA,7,68,85,30,NA,NA,153,13,16,29
2016/2017,2017,07001,Molise,444,604,410,566,10,1048,2851,4084,1803,2946,3722,6935,422,636,1058
2016/2017,2017,07101,Foggia,846,1218,76,1930,21,2064,3761,6014,3019,605,9000,9775,565,1005,1570
2016/2017,2017,07201,Bari,2917,4320,318,6786,134,7237,16685,27661,10228,2758,40856,44346,2643,4912,7555
2016/2017,2017,07202,Bari Politecnico,1220,525,86,1637,19,1745,6645,3004,2414,385,9151,9649,1292,664,1956
2016/2017,2017,07203,Jean Monnet,124,63,NA,162,NA,187,847,519,330,NA,1265,1366,161,104,265
2016/2017,2017,07501,Salento,1161,1805,34,2888,39,2966,6125,10455,4332,247,16088,16580,1027,2097,3124
2016/2017,2017,07601,Basilicata,476,486,172,753,10,962,2870,3829,1367,1387,5136,6699,378,514,892
2016/2017,2017,07801,Calabria,1798,2209,215,3751,106,4007,10983,15488,5736,1029,25215,26471,1792,2690,4482
2016/2017,2017,07901,Catanzaro,644,941,13,1510,22,1585,4068,6220,2335,284,9568,10288,606,951,1557
2016/2017,2017,08001,Reggio Calabria,410,313,27,673,17,723,2904,2943,1157,440,5331,5847,487,441,928
2016/2017,2017,08003,Reggio Calabria - Dante Alighieri,41,140,79,90,89,181,158,795,349,94,770,953,41,178,219
2016/2017,2017,08201,Palermo,3026,3844,14,6795,70,6870,16619,23208,10154,121,39400,39827,2837,4437,7274
2016/2017,2017,08301,Messina,1442,2088,753,2737,45,3530,8510,14348,5594,5419,17121,22858,1264,2424,3688
2016/2017,2017,08601,Enna,305,501,NA,803,6,806,2016,3498,1223,NA,5457,5514,400,751,1151
2016/2017,2017,08701,Catania,2890,3540,NA,6347,55,6430,17914,25506,9101,NA,43017,43420,2532,3905,6437
2016/2017,2017,09001,Sassari,806,1271,NA,2011,41,2077,4717,8164,3521,NA,12390,12881,725,1328,2053
2016/2017,2017,09201,Cagliari,1652,2101,NA,3719,39,3753,10605,15376,5855,NA,25601,25981,1555,2457,4012
2015/2016,2016,00101,Torino,4494,6955,1433,9617,827,11449,25622,40719,18262,10147,54445,66341,4686,7702,12388
2015/2016,2016,00102,Torino Politecnico,3991,1482,2527,2755,612,5473,21811,8689,10103,15236,14858,30500,4470,1954,6424
2015/2016,2016,00201,Piemonte Orientale,1047,1744,608,1887,168,2791,4208,6559,3492,2281,8075,10767,657,1117,1774
2015/2016,2016,00401,Scienze Gastronomiche,35,32,20,NA,23,67,155,167,115,61,NA,322,26,52,78
2015/2016,2016,00701,Aosta,72,146,62,115,9,218,314,804,259,260,723,1118,44,145,189
2015/2016,2016,01001,Genova,2565,2925,483,4718,511,5490,14187,17179,8749,4615,25854,31366,2572,3392,5964
2015/2016,2016,01201,LIUC,242,110,21,208,5,352,1259,692,725,140,1200,1951,397,223,620
2015/2016,2016,01202,Insubria,918,1064,62,1806,110,1982,3998,4878,2592,387,8170,8876,626,868,1494
2015/2016,2016,01301,Novedrate,458,473,481,161,75,931,4013,3850,2204,5421,1539,7863,421,478,899
2015/2016,2016,01501,Milano,4802,7051,1660,9874,814,11853,24899,35501,17214,10190,49919,60400,4446,7032,11478
2015/2016,2016,01502,Milano Politecnico,5194,2341,2285,4889,427,7535,27370,13412,13687,14905,25702,40782,6675,3820,10495
2015/2016,2016,01503,Milano Bocconi,1484,1160,1572,843,325,2644,6960,6285,4616,9256,3970,13245,2359,2263,4622
2015/2016,2016,01504,Milano Cattolica,2649,4698,2337,4484,426,7347,13097,23393,11355,14865,21607,36490,3200,6136,9336
2015/2016,2016,01505,IULM,349,911,232,743,51,1260,1351,3313,1777,1656,2644,4664,325,785,1110
2015/2016,2016,01508,Milano San Raffaele,199,226,55,181,25,425,950,1375,748,519,1172,2325,167,327,494
2015/2016,2016,01509,Milano Bicocca,2228,3231,403,4695,343,5459,12393,19693,9010,3618,27384,32086,2415,4264,6679
2015/2016,2016,01510,Humanitas University,67,82,62,45,75,149,130,214,198,56,190,344,3,4,7
2015/2016,2016,01601,Bergamo,1275,2415,10,3568,200,3690,5802,9836,4924,103,14846,15638,1049,1956,3005
2015/2016,2016,01701,Brescia,1331,1155,43,2341,162,2486,7460,6507,3370,455,13086,13967,1277,1231,2508
2015/2016,2016,01801,Pavia,1753,2275,1096,2707,320,4028,9375,11697,6141,6632,13787,21072,1878,2479,4357
2015/2016,2016,02101,Bolzano,180,417,197,327,70,597,956,2072,826,1001,1738,3028,159,365,524
2015/2016,2016,02201,Trento,1405,1508,1638,1019,74,2913,7968,8266,4432,8742,6269,16234,1773,1803,3576
2015/2016,2016,02301,Verona,1587,3041,1385,3061,246,4628,8084,14593,6951,6633,15553,22677,1433,2932,4365
2015/2016,2016,02701,Ca Foscari,1380,2641,588,3135,213,4021,6955,12813,6568,4368,14756,19768,1555,3230,4785
2015/2016,2016,02702,IUAV,278,351,78,468,31,629,2079,2181,1293,467,3013,4260,632,682,1314
2015/2016,2016,02801,Padova,5070,5675,1335,8959,456,10745,26930,31559,16075,10911,47262,58489,5366,6967,12333
2015/2016,2016,03001,Udine,1502,1543,666,2241,204,3045,7207,7665,4277,3652,10834,14872,1398,1625,3023
2015/2016,2016,03201,Trieste,1081,1456,633,1603,197,2537,6577,8486,3847,4222,9427,15063,1270,1863,3133
2015/2016,2016,03401,Parma,1769,2310,1499,2311,307,4079,10150,12911,6196,10017,12398,23061,1945,2590,4535
2015/2016,2016,03601,Modena e Reggio Emilia,2128,2224,517,3385,316,4352,9809,11014,6835,4235,15745,20823,1779,2264,4043
2015/2016,2016,03701,Bologna,6129,7694,5183,7992,822,13823,34549,43257,22044,34156,43609,77806,7099,9997,17096
2015/2016,2016,03801,Ferrara,1315,1482,1210,1328,173,2797,7062,8456,3996,8366,6649,15518,1222,1643,2865
2015/2016,2016,04101,Carlo Bo,1058,1694,1271,1273,164,2752,5374,8482,3703,6817,6553,13856,871,1649,2520
2015/2016,2016,04201,Marche,1528,1368,715,2041,111,2896,8554,7068,4274,3614,11686,15622,1557,1404,2961
2015/2016,2016,04301,Macerata,501,1332,376,1324,79,1833,2852,7129,3072,1622,7592,9981,444,1306,1750
2015/2016,2016,04302,Camerino,425,517,168,526,82,942,3124,3343,1502,2258,3403,6467,513,548,1061
2015/2016,2016,04801,Firenze,3459,4975,1340,6866,639,8434,20648,29630,13309,9884,40111,50278,3262,4986,8248
2015/2016,2016,04804,IUL,9,31,13,NA,8,40,18,91,76,31,NA,109,3,5,8
2015/2016,2016,05001,Pisa,3590,3679,2043,4938,307,7269,21831,23211,11585,14553,30331,45042,3347,3620,6967
2015/2016,2016,05201,Siena,918,1298,792,1152,159,2216,6508,8957,3727,6451,7686,15465,1153,1754,2907
2015/2016,2016,05202,Siena Stranieri,96,424,111,290,66,520,318,1316,633,410,912,1634,41,257,298
2015/2016,2016,05401,Perugia,1651,2005,739,2588,230,3656,9495,12033,5805,6426,14437,21528,1842,2617,4459
2015/2016,2016,05403,Perugia Stranieri,57,57,15,80,48,114,365,527,277,228,455,892,69,156,225
2015/2016,2016,05601,Tuscia,868,852,288,1248,57,1720,3969,3863,2573,1538,5862,7832,640,602,1242
2015/2016,2016,05801,La Sapienza,6610,8580,2240,12520,860,15190,42362,57496,25009,21187,77631,99858,7348,10853,18201
2015/2016,2016,05802,Tor Vergata,2577,2557,590,4340,362,5134,14453,15216,8924,6107,22707,29669,3002,3023,6025
2015/2016,2016,05803,Roma LUMSA,221,588,255,431,53,809,1817,4066,1470,2098,3076,5883,357,927,1284
2015/2016,2016,05805,Roma LUISS,821,735,522,818,24,1556,4256,3860,2690,3624,3838,8116,1175,1156,2331
2015/2016,2016,05806,Roma Foro Italico,250,98,NA,309,4,348,1612,617,644,NA,1807,2229,326,181,507
2015/2016,2016,05807,Roma Tre,2371,3190,367,5002,299,5561,13802,20140,8877,3607,29104,33942,2448,3751,6199
2015/2016,2016,05808,Campus Biomedico,130,193,20,170,2,323,665,1015,462,185,865,1680,148,296,444
2015/2016,2016,05809,Roma UNINT,61,174,11,153,11,235,347,1057,593,138,821,1404,85,305,390
2015/2016,2016,05810,Roma Marconi,412,355,331,153,20,767,5400,4129,3046,6269,2161,9529,914,708,1622
2015/2016,2016,05811,Unitelma,57,51,NA,29,5,108,813,676,462,NA,598,1489,191,154,345
2015/2016,2016,05812,Roma Europea,43,70,NA,91,3,113,300,461,223,NA,625,761,56,129,185
2015/2016,2016,05813,Uninettuno,321,238,187,100,26,559,6076,3744,1566,5345,2631,9820,320,250,570
2015/2016,2016,05814,Mercatorum,25,23,NA,NA,NA,48,171,112,144,NA,NA,283,1,1,2
2015/2016,2016,05815,Unicusano,1150,622,1076,434,44,1772,10365,6897,6489,12860,3671,17262,1489,1030,2519
2015/2016,2016,05816,Roma San Raffaele,225,125,63,94,9,350,1207,836,954,641,535,2043,134,98,232
2015/2016,2016,05817,Link Campus,243,90,77,120,5,333,1200,549,471,497,715,1749,190,89,279
2015/2016,2016,06001,Cassino,563,623,279,874,28,1186,3555,4270,2096,2034,5552,7825,558,855,1413
2015/2016,2016,06201,Sannio,490,428,34,855,3,918,2678,2812,1300,183,5218,5490,434,469,903
2015/2016,2016,06202,Benevento - Giustino Fortunato,30,10,NA,NA,NA,40,465,280,340,NA,NA,745,121,77,198
2015/2016,2016,06301,Napoli Federico II,5567,6361,343,11461,81,11928,34570,43388,18423,2727,74503,77958,5474,7374,12848
2015/2016,2016,06302,Napoli Parthenope,1228,886,NA,2054,21,2114,7690,6122,3204,NA,13280,13812,1106,1089,2195
2015/2016,2016,06303,Napoli L'Orientale,433,1666,159,1800,91,2099,2368,8312,3008,946,9236,10680,330,1352,1682
2015/2016,2016,06304,Benincasa,181,1038,NA,1170,14,1219,1159,6952,2089,NA,7768,8111,210,1335,1545
2015/2016,2016,06306,Napoli II,1554,1863,21,3248,40,3417,10839,15089,5815,300,24940,25928,1888,2844,4732
2015/2016,2016,06307,Napoli Pegaso,1256,384,853,590,8,1640,8299,4960,8093,6565,5903,13259,1973,1166,3139
2015/2016,2016,06501,Salerno,2539,3046,156,5351,55,5585,14291,20691,7911,1556,32898,34982,1884,3077,4961
2015/2016,2016,06601,Aquila,886,920,496,1198,34,1806,7739,10387,3698,6536,10204,18126,1484,2274,3758
2015/2016,2016,06701,Teramo,394,561,109,749,18,955,2577,3619,1480,1132,4616,6196,424,544,968
2015/2016,2016,06901,Chieti e Pescara,1336,2355,1435,2059,114,3691,9237,16520,5926,11031,14003,25757,1601,3606,5207
2015/2016,2016,07001,Molise,416,572,379,523,17,988,2858,4095,1586,2912,3786,6953,421,665,1086
2015/2016,2016,07101,Foggia,668,793,57,1353,25,1461,3522,5747,2207,596,8522,9269,539,998,1537
2015/2016,2016,07201,Bari,2995,4348,337,6873,106,7343,17305,29163,10526,2918,42804,46468,2666,4880,7546
2015/2016,2016,07202,Bari Politecnico,1056,448,29,1456,13,1504,6741,3052,2017,349,9322,9793,1347,712,2059
2015/2016,2016,07203,Jean Monnet,98,53,NA,130,NA,151,773,464,262,NA,1144,1237,164,102,266
2015/2016,2016,07501,Salento,1143,1739,41,2809,28,2882,6291,10690,4408,274,16466,16981,1081,2236,3317
2015/2016,2016,07601,Basilicata,473,467,182,731,9,940,2971,3953,1369,1516,5332,6924,374,482,856
2015/2016,2016,07801,Calabria,1757,2314,187,3854,69,4071,11141,16034,5895,804,26134,27175,1655,2757,4412
2015/2016,2016,07901,Catanzaro,662,770,NA,1371,16,1432,4149,6158,2008,NA,9654,10307,468,797,1265
2015/2016,2016,08001,Reggio Calabria,418,293,42,646,8,711,3100,3167,1128,478,5706,6267,536,437,973
2015/2016,2016,08003,Reggio Calabria - Dante Alighieri,15,103,NA,105,13,118,161,801,321,NA,886,962,31,185,216
2015/2016,2016,08201,Palermo,2805,3519,26,6200,58,6324,16561,23618,9490,144,39695,40179,2865,4704,7569
2015/2016,2016,08301,Messina,1227,1898,671,2402,30,3125,8762,14915,4838,5727,17624,23677,1473,2894,4367
2015/2016,2016,08601,Enna,348,536,NA,877,7,884,2226,3563,1351,NA,5727,5789,395,699,1094
2015/2016,2016,08701,Catania,2845,3636,NA,6397,46,6481,18254,26883,9066,NA,44689,45137,2468,3984,6452
2015/2016,2016,09001,Sassari,677,1062,NA,1669,31,1739,4567,7891,3120,NA,12012,12458,673,1294,1967
2015/2016,2016,09201,Cagliari,1762,2212,11,3929,41,3974,10653,15580,6036,105,25859,26233,1493,2436,3929
2014/2015,2015,00101,Torino,4283,6731,1338,9425,697,11014,25312,40729,18010,9446,55088,66041,4401,7390,11791
2014/2015,2015,00102,Torino Politecnico,3828,1542,2462,2698,685,5370,21193,8433,9568,14188,15021,29626,4490,1937,6427
2014/2015,2015,00201,Piemonte Orientale,867,1435,385,1754,153,2302,4067,6332,3123,1932,8088,10399,635,1126,1761
2014/2015,2015,00401,Scienze Gastronomiche,29,36,22,NA,30,65,131,164,113,56,NA,295,32,39,71
2014/2015,2015,00701,Aosta,55,163,46,129,17,218,316,836,321,254,770,1152,46,138,184
2014/2015,2015,01001,Genova,2564,2964,549,4668,478,5528,14465,17776,9079,4715,26472,32241,2510,3403,5913
2014/2015,2015,01201,LIUC,171,106,10,177,7,277,1143,674,633,117,1167,1817,319,216,535
2014/2015,2015,01202,Insubria,976,1287,76,2064,131,2263,3895,4971,2727,423,8130,8866,662,904,1566
2014/2015,2015,01301,Novedrate,513,506,523,184,80,1019,3977,3687,2800,5268,1523,7664,406,508,914
2014/2015,2015,01501,Milano,4669,6769,1557,9562,756,11438,25082,35596,17656,9645,50388,60678,4228,6642,10870
2014/2015,2015,01502,Milano Politecnico,4944,2326,2140,4732,400,7270,26744,13335,13150,13796,26149,40079,6540,3829,10369
2014/2015,2015,01503,Milano Bocconi,1232,1173,1478,740,215,2405,6880,6449,4388,9385,3881,13329,2235,2148,4383
2014/2015,2015,01504,Milano Cattolica,2529,4516,2108,4430,403,7045,13023,23401,11017,14135,21966,36424,3066,6136,9202
2014/2015,2015,01505,IULM,280,807,155,623,55,1087,1269,3049,1582,1279,2458,4318,313,822,1135
2014/2015,2015,01508,Milano San Raffaele,129,248,43,140,28,377,866,1259,697,217,1116,2125,160,284,444
2014/2015,2015,01509,Milano Bicocca,2356,3389,506,4889,366,5745,12329,19824,9171,3738,27566,32153,2245,4232,6477
2014/2015,2015,01601,Bergamo,1209,2196,15,3292,224,3405,5537,9323,4663,104,14198,14860,1032,1840,2872
2014/2015,2015,01701,Brescia,1407,1184,69,2422,180,2591,7494,6651,3903,441,13256,14145,1241,1238,2479
2014/2015,2015,01801,Pavia,1697,2114,1052,2554,292,3811,9459,11812,6025,6527,13990,21271,1953,2632,4585
2014/2015,2015,02101,Bolzano,197,401,185,340,89,598,899,1859,806,989,1586,2758,161,292,453
2014/2015,2015,02201,Trento,1489,1544,1651,1162,107,3033,8171,8383,4879,9129,6774,16554,1662,1864,3526
2014/2015,2015,02301,Verona,1511,2880,1265,2955,261,4391,7833,14197,6546,6441,15268,22030,1432,2989,4421
2014/2015,2015,02701,Ca Foscari,1244,2356,540,2751,198,3600,6789,12393,5751,3981,14574,19182,1472,3164,4636
2014/2015,2015,02702,IUAV,329,425,69,553,32,754,2240,2272,1376,508,3190,4512,684,740,1424
2014/2015,2015,02801,Padova,5044,5624,1454,8766,460,10668,26719,31740,16397,9990,47584,58459,4974,6538,11512
2014/2015,2015,03001,Udine,1313,1497,589,2084,165,2810,7147,7801,4164,3473,10893,14948,1204,1676,2880
2014/2015,2015,03201,Trieste,1036,1381,613,1527,193,2417,6764,8809,3772,4546,9765,15573,1293,1891,3184
2014/2015,2015,03401,Parma,1455,1850,1017,2025,226,3305,10154,13205,5751,9731,12630,23359,2005,2788,4793
2014/2015,2015,03601,Modena e Reggio Emilia,1958,1943,408,3155,259,3901,9120,10576,6066,3751,15317,19696,1618,2193,3811
2014/2015,2015,03701,Bologna,5953,7389,4844,7838,850,13342,33877,43044,21632,33073,43808,76921,6865,9797,16662
2014/2015,2015,03801,Ferrara,1137,1435,1118,1242,155,2572,7032,8618,3902,8446,6669,15650,1284,1714,2998
2014/2015,2015,04101,Carlo Bo,1042,1643,1214,1264,170,2685,5415,8558,3799,6722,6755,13973,808,1551,2359
2014/2015,2015,04201,Marche,1528,1321,562,2109,124,2849,8615,7114,4376,3251,12030,15729,1603,1484,3087
2014/2015,2015,04301,Macerata,436,1241,241,1288,93,1677,2813,6916,2903,1331,7515,9729,433,1253,1686
2014/2015,2015,04302,Camerino,461,514,149,586,79,975,3237,3446,1458,1839,3504,6683,583,617,1200
2014/2015,2015,04801,Firenze,3607,4922,1324,6968,666,8529,20987,30156,13602,9628,41256,51143,2944,4970,7914
2014/2015,2015,04804,IUL,3,20,NA,NA,NA,23,5,35,28,NA,NA,40,1,6,7
2014/2015,2015,05001,Pisa,3667,3470,1974,4904,291,7137,22026,23314,11486,13875,30847,45340,3248,3701,6949
2014/2015,2015,05201,Siena,909,1269,767,1179,136,2178,6507,9106,3723,6738,8017,15613,1143,1751,2894
2014/2015,2015,05202,Siena Stranieri,86,347,81,233,64,433,267,1128,562,358,804,1395,35,185,220
2014/2015,2015,05401,Perugia,1614,1917,632,2575,212,3531,9749,12586,5583,6478,14856,22335,1877,2476,4353
2014/2015,2015,05403,Perugia Stranieri,41,73,35,67,47,114,359,630,275,295,457,989,83,172,255
2014/2015,2015,05601,Tuscia,849,814,190,1284,49,1663,3866,3740,2458,1350,5731,7606,611,649,1260
2014/2015,2015,05801,La Sapienza,6504,8460,2581,12027,827,14964,43104,59390,25279,23043,78650,102494,7147,10850,17997
2014/2015,2015,05802,Tor Vergata,2618,2780,895,4348,338,5398,14803,15484,10072,6290,23242,30287,2697,2967,5664
2014/2015,2015,05803,Roma LUMSA,261,585,205,483,60,846,1903,3984,1505,2409,3087,5887,370,855,1225
2014/2015,2015,05805,Roma LUISS,784,636,482,714,18,1420,3914,3790,2352,3747,3533,7704,1047,1084,2131
2014/2015,2015,05806,Roma Foro Italico,248,75,NA,265,6,323,1556,650,642,NA,1747,2206,300,170,470
2014/2015,2015,05807,Roma Tre,2464,3300,424,5181,332,5764,14295,20534,9490,4400,29720,34829,2384,3636,6020
2014/2015,2015,05808,Campus Biomedico,104,164,10,143,3,268,659,982,445,193,842,1641,125,221,346
2014/2015,2015,05809,Roma UNINT,39,176,NA,161,12,215,331,965,597,NA,738,1296,90,245,335
2014/2015,2015,05810,Roma Marconi,378,300,263,134,25,678,5005,3477,2583,5346,1908,8482,871,649,1520
2014/2015,2015,05811,Unitelma,56,51,NA,37,2,107,838,742,513,NA,611,1580,165,145,310
2014/2015,2015,05812,Roma Europea,41,80,NA,92,4,121,311,495,209,NA,657,806,81,152,233
2014/2015,2015,05813,Uninettuno,326,169,147,99,42,495,5713,3529,1240,3617,2584,9242,324,193,517
2014/2015,2015,05814,Mercatorum,23,10,NA,NA,2,33,161,103,126,NA,NA,264,8,10,18
2014/2015,2015,05815,Unicusano,893,559,814,310,35,1452,8585,5670,5780,10210,3009,14255,1453,900,2353
2014/2015,2015,05816,Roma San Raffaele,172,85,41,57,4,257,858,532,591,393,338,1390,88,56,144
2014/2015,2015,05817,Link Campus,123,64,50,61,8,187,929,484,386,392,619,1413,255,116,371
2014/2015,2015,06001,Cassino,607,684,314,934,39,1291,3682,4507,2154,2182,5795,8189,577,820,1397
2014/2015,2015,06201,Sannio,482,492,31,915,5,974,2760,3049,1264,136,5585,5809,415,509,924
2014/2015,2015,06202,Benevento - Giustino Fortunato,34,7,NA,10,NA,41,385,241,280,NA,377,626,99,54,153
2014/2015,2015,06301,Napoli Federico II,5552,6450,333,11518,67,12002,35362,45269,18996,2702,77024,80631,5503,7345,12848
2014/2015,2015,06302,Napoli Parthenope,1326,971,14,2235,14,2297,8127,6519,3890,122,14070,14646,1199,963,2162
2014/2015,2015,06303,Napoli L'Orientale,489,1560,188,1742,74,2049,2347,8110,2943,1080,9137,10457,316,1290,1606
2014/2015,2015,06304,Benincasa,179,1070,13,1187,11,1249,1161,6821,2233,95,7651,7982,227,1375,1602
2014/2015,2015,06306,Napoli II,1492,2016,32,3346,54,3508,10918,15421,6367,280,25484,26339,1761,2672,4433
2014/2015,2015,06307,Napoli Pegaso,862,408,608,499,4,1270,6936,3869,6343,4884,5077,10805,1681,908,2589
2014/2015,2015,06501,Salerno,2323,2958,192,5024,58,5281,13981,20952,7897,1631,32820,34933,1715,2954,4669
2014/2015,2015,06601,Aquila,1032,1157,728,1298,62,2189,9106,12130,4363,8416,11687,21236,1465,1954,3419
2014/2015,2015,06701,Teramo,400,532,92,711,25,932,2604,3723,1492,1100,4688,6327,414,569,983
2014/2015,2015,06901,Chieti e Pescara,1451,2499,1607,2149,103,3950,9709,17651,6576,11900,14802,27360,1651,3695,5346
2014/2015,2015,06902,Torrevecchia Teatina,1,NA,NA,NA,NA,NA,83,124,NA,NA,NA,207,26,23,49
2014/2015,2015,07001,Molise,443,524,349,533,11,967,2884,4136,1554,2922,3863,7020,396,647,1043
2014/2015,2015,07101,Foggia,617,947,60,1465,13,1564,3470,6055,2519,620,8754,9525,542,924,1466
2014/2015,2015,07201,Bari,3180,4744,445,7331,141,7924,17820,30701,11444,3101,44607,48521,2386,4911,7297
2014/2015,2015,07202,Bari Politecnico,982,405,26,1336,16,1387,7024,3269,2003,378,9773,10293,1095,559,1654
2014/2015,2015,07203,Jean Monnet,94,46,NA,117,1,140,750,497,235,NA,1147,1247,199,128,327
2014/2015,2015,07501,Salento,1100,1737,35,2764,30,2837,6531,11377,4272,302,17344,17908,979,2289,3268
2014/2015,2015,07601,Basilicata,427,511,137,755,12,938,3019,4195,1436,1453,5581,7214,351,540,891
2014/2015,2015,07801,Calabria,1700,2188,52,3789,74,3888,11712,16915,5974,571,27773,28627,1671,2769,4440
2014/2015,2015,07901,Catanzaro,694,994,NA,1592,10,1688,4199,6546,2628,NA,10147,10745,428,669,1097
2014/2015,2015,08001,Reggio Calabria,439,386,45,762,11,825,3371,3437,1167,521,6210,6808,510,503,1013
2014/2015,2015,08003,Reggio Calabria - Dante Alighieri,20,114,NA,126,23,134,156,748,325,NA,868,904,26,124,150
2014/2015,2015,08201,Palermo,3012,3789,13,6730,43,6801,17419,25039,10752,139,41963,42458,2932,4853,7785
2014/2015,2015,08301,Messina,1339,2102,760,2595,48,3441,9262,16269,5420,6343,18837,25531,1401,2920,4321
2014/2015,2015,08601,Enna,385,567,NA,933,2,952,2357,3601,1667,NA,5894,5958,384,662,1046
2014/2015,2015,08701,Catania,2532,3207,NA,5667,31,5739,18557,28208,8896,NA,46294,46765,2538,4281,6819
2014/2015,2015,09001,Sassari,683,1123,NA,1713,26,1806,4590,8260,2992,NA,12442,12850,716,1372,2088
2014/2015,2015,09201,Cagliari,1599,2058,NA,3616,37,3657,10689,15973,5817,NA,26299,26662,1447,2446,3893
2013/2014,2014,00101,Torino,4036,6574,1067,9268,694,10610,24936,40539,17371,8444,55371,65475,4367,7189,11556
2013/2014,2014,00102,Torino Politecnico,3728,1391,2226,2691,743,5119,20599,8207,9425,12544,15301,28806,4168,2003,6171
2013/2014,2014,00201,Piemonte Orientale,820,1343,321,1669,147,2163,3961,6133,2964,1800,7917,10094,568,1014,1582
2013/2014,2014,00401,Scienze Gastronomiche,21,42,19,10,21,63,119,145,103,55,82,264,34,42,76
2013/2014,2014,00701,Aosta,72,158,46,138,21,230,325,836,302,233,808,1161,46,148,194
2013/2014,2014,01001,Genova,2592,3002,614,4725,505,5594,14604,18107,8997,4664,26970,32711,2563,3673,6236
2013/2014,2014,01201,LIUC,163,82,NA,138,7,245,1092,666,540,NA,1135,1758,310,191,501
2013/2014,2014,01202,Insubria,662,1027,93,1469,111,1689,3747,4785,2164,435,7767,8532,634,863,1497
2013/2014,2014,01301,Novedrate,396,380,328,134,49,776,3590,3134,2376,4519,1346,6724,382,430,812
2013/2014,2014,01501,Milano,4958,7277,1640,10279,830,12235,24829,35541,17972,9680,50437,60370,3990,6691,10681
2013/2014,2014,01502,Milano Politecnico,5068,2374,2018,5048,349,7442,26508,13296,14383,12726,26800,39804,6261,3781,10042
2013/2014,2014,01503,Milano Bocconi,1389,1366,1697,860,287,2755,6920,6649,4784,9539,3966,13569,2216,2131,4347
2013/2014,2014,01504,Milano Cattolica,2512,4528,2025,4431,464,7040,13044,23743,10737,13856,22425,36787,3101,6493,9594
2013/2014,2014,01505,IULM,275,691,137,571,53,966,1264,2935,1399,980,2420,4199,324,821,1145
2013/2014,2014,01508,Milano San Raffaele,152,181,41,120,23,333,855,1146,688,181,1120,2001,171,337,508
2013/2014,2014,01509,Milano Bicocca,2295,3332,388,4875,385,5627,12244,19930,9056,3404,27846,32174,2269,4275,6544
2013/2014,2014,01601,Bergamo,949,1884,10,2733,177,2833,5359,9017,4018,98,13756,14376,1089,1861,2950
2013/2014,2014,01701,Brescia,1312,1262,63,2431,219,2574,7490,6714,3473,477,13325,14204,1133,1148,2281
2013/2014,2014,01801,Pavia,1708,2058,1079,2473,254,3766,9652,11885,5914,6870,14191,21537,1868,2580,4448
2013/2014,2014,02101,Bolzano,152,413,149,321,68,565,829,1823,725,867,1573,2652,178,452,630
2013/2014,2014,02201,Trento,1553,1422,1546,1241,121,2975,8173,8360,4811,8612,7248,16533,1615,1852,3467
2013/2014,2014,02301,Verona,1452,2859,1268,2864,211,4311,7760,14185,6212,6123,15315,21945,1419,3098,4517
2013/2014,2014,02701,Ca Foscari,1349,2400,612,2849,197,3749,6798,12585,6055,3909,15041,19383,1325,3011,4336
2013/2014,2014,02702,IUAV,347,409,105,535,40,756,2408,2317,1513,859,3373,4725,738,797,1535
2013/2014,2014,02801,Padova,4823,5570,1420,8618,439,10393,26218,32148,15998,10003,48116,58366,4980,7139,12119
2013/2014,2014,03001,Udine,1350,1500,627,2117,238,2850,7112,8085,4266,3574,11081,15197,1233,1705,2938
2013/2014,2014,03201,Trieste,1100,1458,702,1613,200,2558,7193,9352,3983,4971,10389,16545,1305,1999,3304
2013/2014,2014,03401,Parma,1549,1904,1157,2070,308,3453,10792,14143,5936,10433,13539,24935,2137,3077,5214
2013/2014,2014,03601,Modena e Reggio Emilia,1797,2093,269,3319,282,3890,8924,10627,6054,2560,15537,19551,1621,2122,3743
2013/2014,2014,03701,Bologna,5829,7454,4436,8157,880,13283,34115,43530,21008,32432,45169,77645,6743,9829,16572
2013/2014,2014,03801,Ferrara,1073,1285,1021,1117,137,2358,7174,8739,3673,8261,6817,15913,1159,1738,2897
2013/2014,2014,04101,Carlo Bo,1034,1576,1246,1211,170,2610,5420,8548,3866,6758,6812,13968,835,1737,2572
2013/2014,2014,04201,Marche,1506,1349,550,2129,129,2855,8676,6992,4284,3153,12247,15668,1501,1480,2981
2013/2014,2014,04301,Macerata,395,1092,196,1166,70,1487,2897,6933,2599,1472,7593,9830,383,1296,1679
2013/2014,2014,04302,Camerino,418,501,155,536,90,919,3355,3555,1503,2218,3615,6910,503,545,1048
2013/2014,2014,04801,Firenze,3351,4690,1069,6711,661,8041,20802,29676,13006,8633,41257,50478,3167,5171,8338
2013/2014,2014,04804,IUL,NA,1,NA,NA,NA,NA,3,18,NA,NA,NA,21,NA,5,NA
2013/2014,2014,05001,Pisa,3376,3479,1738,4863,307,6855,21730,23404,11220,13550,30900,45134,3110,3463,6573
2013/2014,2014,05201,Siena,880,1392,786,1234,132,2272,6494,9287,3783,6516,8257,15781,1135,1714,2849
2013/2014,2014,05202,Siena Stranieri,61,282,69,201,67,343,211,925,442,222,670,1136,31,134,165
2013/2014,2014,05401,Perugia,1515,1851,565,2482,178,3366,9956,12939,5583,7274,14980,22895,1868,2640,4508
2013/2014,2014,05403,Perugia Stranieri,38,82,30,63,46,120,392,708,271,319,480,1100,74,193,267
2013/2014,2014,05601,Tuscia,798,787,244,1183,42,1585,3756,3681,2484,1395,5519,7437,681,622,1303
2013/2014,2014,05801,La Sapienza,6249,8122,2564,11543,811,14371,42982,60569,25463,23884,78798,103551,7326,11577,18903
2013/2014,2014,05802,Tor Vergata,2591,2478,763,4130,246,5069,15121,15474,9811,6217,23571,30595,2877,2953,5830
2013/2014,2014,05803,Roma LUMSA,260,600,248,456,46,860,1953,4080,1516,2346,3149,6033,375,1104,1479
2013/2014,2014,05805,Roma LUISS,725,677,488,710,15,1402,3736,3887,2295,3273,3416,7623,1150,1175,2325
2013/2014,2014,05806,Roma Foro Italico,232,95,NA,270,3,327,1524,683,643,NA,1779,2207,267,145,412
2013/2014,2014,05807,Roma Tre,2524,3287,496,5174,320,5811,14418,20989,9683,4833,30054,35407,2262,3599,5861
2013/2014,2014,05808,Campus Biomedico,120,175,34,157,1,295,626,941,473,344,787,1567,146,231,377
2013/2014,2014,05809,Roma UNINT,46,140,NA,121,2,186,365,833,482,NA,656,1198,120,242,362
2013/2014,2014,05810,Roma Marconi,433,297,274,136,18,730,7891,4382,2780,8087,2604,12273,980,569,1549
2013/2014,2014,05811,Unitelma,51,53,NA,38,3,104,892,787,551,NA,638,1679,180,158,338
2013/2014,2014,05812,Roma Europea,61,81,NA,112,2,142,340,547,239,NA,706,887,78,170,248
2013/2014,2014,05813,Uninettuno,240,163,121,77,56,403,5279,3315,997,3618,2489,8594,278,169,447
2013/2014,2014,05814,Mercatorum,29,19,NA,12,1,48,160,91,141,NA,83,251,24,8,32
2013/2014,2014,05815,Unicusano,453,320,365,163,23,773,7327,4610,3694,7518,2510,11937,1558,857,2415
2013/2014,2014,05816,Roma San Raffaele,123,57,12,41,6,180,609,356,336,147,206,965,39,27,66
2013/2014,2014,05817,Link Campus,101,58,24,63,3,159,787,400,1184,236,612,1187,85,51,136
2013/2014,2014,06001,Cassino,595,712,339,927,33,1307,3851,4770,2183,2312,6142,8621,545,809,1354
2013/2014,2014,06201,Sannio,489,603,11,1061,5,1092,2969,3227,1476,82,5975,6196,372,471,843
2013/2014,2014,06202,Benevento - Giustino Fortunato,29,13,NA,NA,NA,42,350,194,263,NA,NA,544,76,55,131
2013/2014,2014,06301,Napoli Federico II,5563,6575,284,11707,63,12138,35749,46399,19430,2714,78429,82148,5349,7346,12695
2013/2014,2014,06302,Napoli Parthenope,1533,1081,13,2538,22,2614,8655,6847,4027,115,14874,15502,1379,1231,2610
2013/2014,2014,06303,Napoli L'Orientale,459,1704,201,1867,95,2163,2299,8185,3121,1013,9290,10484,318,1311,1629
2013/2014,2014,06304,Benincasa,174,1070,NA,1196,12,1244,1195,6885,2156,NA,7783,8080,242,1614,1856
2013/2014,2014,06306,Napoli II,1468,1836,20,3173,33,3304,11138,15541,6320,26,25881,26679,1714,2750,4464
2013/2014,2014,06307,Napoli Pegaso,1332,586,847,829,1,1918,5862,3055,6734,3484,4564,8917,1260,671,1931
2013/2014,2014,06501,Salerno,2070,2819,174,4648,56,4889,13680,21332,7273,1620,32839,35012,1684,3114,4798
2013/2014,2014,06601,Aquila,1626,2003,1781,1755,79,3629,10524,13512,6881,10194,13100,24036,1420,1900,3320
2013/2014,2014,06701,Teramo,385,489,116,686,17,874,2758,3931,1589,1313,4961,6689,416,583,999
2013/2014,2014,06901,Chieti e Pescara,1532,2680,1717,2324,105,4212,10055,18529,7188,12287,15540,28584,1617,3813,5430
2013/2014,2014,06902,Torrevecchia Teatina,6,5,NA,NA,NA,11,132,158,58,NA,NA,290,24,30,54
2013/2014,2014,07001,Molise,449,538,285,615,14,987,2995,4328,1592,2958,4120,7323,436,722,1158
2013/2014,2014,07101,Foggia,559,957,81,1382,16,1516,3503,6116,2455,654,8802,9619,556,937,1493
2013/2014,2014,07201,Bari,3202,4909,437,7537,149,8111,18049,32109,11632,3109,46175,50158,2430,5267,7697
2013/2014,2014,07202,Bari Politecnico,1040,458,47,1424,19,1498,7319,3389,2279,400,10163,10708,1121,577,1698
2013/2014,2014,07203,Jean Monnet,83,58,NA,115,4,141,782,518,253,NA,1143,1300,173,96,269
2013/2014,2014,07501,Salento,1078,1714,39,2698,37,2792,6693,12186,4265,310,18288,18879,1013,2365,3378
2013/2014,2014,07601,Basilicata,435,522,128,794,6,957,3212,4233,1348,1492,5872,7445,397,625,1022
2013/2014,2014,07801,Calabria,1768,2341,54,4012,50,4109,12360,18140,6189,597,29597,30500,1759,3005,4764
2013/2014,2014,07901,Catanzaro,724,1068,NA,1724,15,1792,4061,6379,2805,NA,9944,10440,421,784,1205
2013/2014,2014,08001,Reggio Calabria,530,427,21,910,13,957,3780,3871,1698,613,6941,7651,568,501,1069
2013/2014,2014,08003,Reggio Calabria - Dante Alighieri,19,94,NA,106,8,113,120,645,273,NA,743,765,18,134,152
2013/2014,2014,08201,Palermo,2989,3721,20,6624,51,6710,17949,26207,10893,157,43615,44156,2966,4976,7942
2013/2014,2014,08301,Messina,1332,2337,779,2825,44,3669,9673,16939,6079,6730,19519,26612,1470,2794,4264
2013/2014,2014,08601,Enna,456,668,NA,1119,9,1124,2443,3583,1781,NA,5970,6026,361,655,1016
2013/2014,2014,08701,Catania,2570,3281,NA,5761,23,5851,19431,30239,8928,NA,49145,49670,2622,4365,6987
2013/2014,2014,09001,Sassari,650,1025,10,1611,35,1675,4750,8582,2873,63,12968,13332,656,1421,2077
2013/2014,2014,09201,Cagliari,1594,2147,10,3699,36,3741,11050,16764,5824,102,27432,27814,1532,2470,4002
2012/2013,2013,00101,Torino,4008,6824,1182,9392,739,10832,24892,40819,17784,8348,56145,65711,4528,7287,11815
2012/2013,2013,00102,Torino Politecnico,3267,1389,1914,2553,606,4656,19854,7940,8878,11576,15729,27794,3696,1786,5482
2012/2013,2013,00201,Piemonte Orientale,770,1223,316,1488,168,1993,3914,6085,2917,1769,7956,9999,645,1100,1745
2012/2013,2013,00401,Scienze Gastronomiche,23,39,19,NA,23,62,126,142,83,69,NA,268,39,52,91
2012/2013,2013,00701,Aosta,69,143,31,142,11,212,334,873,310,214,877,1207,53,174,227
2012/2013,2013,01001,Genova,2412,2962,584,4555,479,5374,14932,18947,8925,4624,28027,33879,2591,3702,6293
2012/2013,2013,01201,LIUC,145,112,NA,168,7,257,1108,653,553,NA,1185,1761,369,161,530
2012/2013,2013,01202,Insubria,722,937,64,1501,127,1659,3817,4815,2274,407,7914,8632,654,927,1581
2012/2013,2013,01301,Novedrate,302,281,200,89,59,583,3395,2758,2312,3492,1195,6153,368,318,686
2012/2013,2013,01501,Milano,4569,6599,1340,9499,743,11168,24600,35359,17473,9101,50255,59959,3973,6494,10467
2012/2013,2013,01502,Milano Politecnico,5156,2380,2007,5191,425,7536,26007,13077,13508,11846,27173,39084,5990,3586,9576
2012/2013,2013,01503,Milano Bocconi,1297,1392,1785,736,318,2689,6868,6558,4727,9463,3943,13426,2183,2043,4226
2012/2013,2013,01504,Milano Cattolica,2520,4566,2135,4411,405,7086,13290,24484,10691,14296,23425,37774,3132,6456,9588
2012/2013,2013,01505,IULM,236,604,94,480,53,840,1276,2970,1293,771,2442,4246,263,717,980
2012/2013,2013,01508,Milano San Raffaele,130,209,32,162,26,339,837,1153,660,172,1165,1990,158,316,474
2012/2013,2013,01509,Milano Bicocca,2441,3741,483,5351,398,6182,12277,20252,9237,3472,28361,32529,2039,3886,5925
2012/2013,2013,01601,Bergamo,1005,1870,15,2778,171,2875,5453,9081,4121,94,13925,14534,940,1741,2681
2012/2013,2013,01701,Brescia,1463,1225,53,2541,204,2688,7546,6668,3649,423,13318,14214,1183,1169,2352
2012/2013,2013,01801,Pavia,1718,2211,1132,2587,310,3929,9668,12206,6182,6649,14569,21874,1843,2564,4407
2012/2013,2013,02101,Bolzano,149,371,135,327,63,520,859,1900,620,850,1730,2759,180,531,711
2012/2013,2013,02201,Trento,1455,1466,1497,1223,138,2921,8077,8473,4683,8329,7566,16550,1537,1693,3230
2012/2013,2013,02301,Verona,1494,2832,1276,2887,278,4326,7987,14638,6402,6413,15929,22625,1369,2967,4336
2012/2013,2013,02701,Ca Foscari,1244,2561,503,2965,209,3805,6490,12207,5976,3235,14833,18697,1324,2861,4185
2012/2013,2013,02702,IUAV,371,409,110,534,46,780,2679,2500,1534,937,3747,5179,812,843,1655
2012/2013,2013,02801,Padova,4854,5641,1324,8863,485,10495,26308,33051,16035,9355,49491,59359,5067,7322,12389
2012/2013,2013,03001,Udine,1337,1580,635,2138,245,2917,7263,8361,4375,3629,11441,15624,1236,1757,2993
2012/2013,2013,03201,Trieste,1160,1469,661,1687,228,2629,7528,9833,4108,4945,10927,17361,1299,2030,3329
2012/2013,2013,03401,Parma,1598,2142,1216,2281,267,3740,11457,15023,6327,11117,14442,26480,2260,3094,5354
2012/2013,2013,03601,Modena e Reggio Emilia,1784,2019,322,3140,277,3803,8782,10386,5930,2309,15137,19168,1532,2114,3646
2012/2013,2013,03701,Bologna,5815,7081,4313,7856,880,12896,34260,44341,20373,31981,46576,78601,6410,9472,15882
2012/2013,2013,03801,Ferrara,1086,1231,1014,1098,140,2317,7400,9262,3714,8758,7238,16662,1253,1836,3089
2012/2013,2013,04101,Carlo Bo,1023,1459,1038,1243,157,2482,5596,8854,3760,7044,7123,14450,913,1720,2633
2012/2013,2013,04201,Marche,1403,1227,410,2090,132,2630,8843,7032,4196,2903,12609,15875,1588,1473,3061
2012/2013,2013,04301,Macerata,455,967,147,1130,78,1422,3040,7244,2559,1177,7978,10284,439,1359,1798
2012/2013,2013,04302,Camerino,467,484,147,631,73,951,3587,3708,1597,2172,3802,7295,525,519,1044
2012/2013,2013,04801,Firenze,3336,4681,1049,6653,654,8017,21289,30477,13147,8082,42593,51766,3142,5274,8416
2012/2013,2013,04804,IUL,1,3,NA,NA,NA,4,5,19,6,NA,NA,24,2,1,3
2012/2013,2013,05001,Pisa,3380,3414,1765,4736,272,6794,21666,23525,10762,13469,31080,45191,3208,3575,6783
2012/2013,2013,05201,Siena,998,1287,872,1192,108,2285,6745,9632,3976,6713,8709,16377,1271,1989,3260
2012/2013,2013,05202,Siena Stranieri,53,243,44,163,60,296,165,787,383,169,562,952,17,115,132
2012/2013,2013,05401,Perugia,1848,2505,1423,2676,220,4353,10751,14164,6989,8411,16001,24915,1863,2763,4626
2012/2013,2013,05403,Perugia Stranieri,46,88,43,68,53,134,449,775,356,347,503,1224,88,185,273
2012/2013,2013,05601,Tuscia,707,776,151,1194,42,1483,3656,3584,2479,1420,5266,7240,731,676,1407
2012/2013,2013,05801,La Sapienza,6410,8447,2608,11960,892,14857,44883,64327,26024,25272,82744,109210,7339,11904,19243
2012/2013,2013,05802,Tor Vergata,2750,2499,754,4371,275,5249,15104,15966,9184,5795,24374,31070,2434,3051,5485
2012/2013,2013,05803,Roma LUMSA,301,601,236,503,58,902,2050,4308,1621,2073,3439,6358,435,1077,1512
2012/2013,2013,05805,Roma LUISS,690,665,525,663,24,1355,3728,4025,2261,4019,3348,7753,1027,1213,2240
2012/2013,2013,05806,Roma Foro Italico,246,80,NA,261,3,326,1486,662,611,NA,1744,2148,280,152,432
2012/2013,2013,05807,Roma Tre,2544,3428,542,5276,335,5972,14470,21284,9697,4828,30175,35754,2306,3573,5879
2012/2013,2013,05808,Campus Biomedico,116,170,25,147,1,286,618,920,460,265,786,1538,131,215,346
2012/2013,2013,05809,Roma UNINT,36,104,13,83,2,140,405,803,417,183,636,1208,104,269,373
2012/2013,2013,05810,Roma Marconi,384,283,239,148,15,667,7448,3875,2653,6486,2380,11323,1016,573,1589
2012/2013,2013,05811,Unitelma,46,53,20,13,2,99,913,821,645,547,645,1734,140,115,255
2012/2013,2013,05812,Roma Europea,62,85,NA,115,4,147,371,569,259,NA,735,940,91,136,227
2012/2013,2013,05813,Uninettuno,248,172,123,78,53,420,4914,3107,960,3358,2363,8021,110,81,191
2012/2013,2013,05814,Mercatorum,12,11,NA,NA,2,23,137,63,76,NA,NA,200,24,2,26
2012/2013,2013,05815,Unicusano,443,299,374,162,18,742,7410,4091,3351,7069,2605,11501,1619,790,2409
2012/2013,2013,05816,Roma San Raffaele,165,76,34,48,10,241,551,291,487,133,175,842,46,19,65
2012/2013,2013,06001,Cassino,657,683,292,1024,25,1340,4080,5049,2343,2340,6626,9129,605,856,1461
2012/2013,2013,06201,Sannio,450,436,NA,841,9,886,3003,3267,1288,NA,6047,6270,389,485,874
2012/2013,2013,06202,Benevento - Giustino Fortunato,16,3,NA,NA,NA,19,303,183,207,NA,NA,486,76,35,111
2012/2013,2013,06301,Napoli Federico II,5626,6864,285,12073,73,12490,36672,48001,20074,2912,80808,84673,5548,7300,12848
2012/2013,2013,06302,Napoli Parthenope,1518,1115,25,2536,20,2633,8780,7060,4075,273,15150,15840,1092,1033,2125
2012/2013,2013,06303,Napoli L'Orientale,457,1614,106,1849,90,2071,2290,8109,3084,713,9337,10399,323,1329,1652
2012/2013,2013,06304,Benincasa,170,1005,12,1128,7,1175,1356,7673,2146,106,8684,9029,247,1619,1866
2012/2013,2013,06306,Napoli II,1561,2125,NA,3596,18,3686,11805,16404,6624,NA,27413,28209,1819,2749,4568
2012/2013,2013,06307,Napoli Pegaso,471,364,232,393,2,835,2910,1810,2439,1502,2530,4720,1053,504,1557
2012/2013,2013,06501,Salerno,2083,2881,165,4739,54,4964,13849,21978,7529,1635,33626,35827,1713,2838,4551
2012/2013,2013,06601,Aquila,1590,1930,1535,1867,81,3520,10809,13538,7000,9910,13688,24347,1495,1912,3407
2012/2013,2013,06701,Teramo,319,452,115,601,20,771,3011,4078,1283,1474,5121,7089,634,620,1254
2012/2013,2013,06901,Chieti e Pescara,1582,2918,1982,2289,79,4500,10436,19518,7584,13085,16333,29954,1669,3740,5409
2012/2013,2013,06902,Torrevecchia Teatina,12,17,NA,NA,2,29,142,184,92,NA,NA,326,15,28,43
2012/2013,2013,07001,Molise,447,584,323,635,14,1031,3102,4386,1757,3035,4201,7488,412,784,1196
2012/2013,2013,07101,Foggia,591,944,59,1440,22,1535,3731,6293,2595,526,9156,10024,537,986,1523
2012/2013,2013,07201,Bari,3288,5074,423,7770,125,8362,18414,33497,12148,3364,47875,51911,2616,5355,7971
2012/2013,2013,07202,Bari Politecnico,1058,420,34,1419,15,1478,7667,3519,2055,408,10610,11186,1212,576,1788
2012/2013,2013,07203,Jean Monnet,78,68,NA,120,1,146,816,491,270,NA,1103,1307,176,82,258
2012/2013,2013,07501,Salento,1140,1907,38,2968,25,3047,6988,13222,4681,332,19580,20210,1067,2457,3524
2012/2013,2013,07601,Basilicata,473,515,137,796,3,988,3479,4451,1448,1467,6308,7930,445,668,1113
2012/2013,2013,07801,Calabria,1786,2418,59,4106,63,4204,12767,18836,6322,560,30716,31603,1706,2925,4631
2012/2013,2013,07901,Catanzaro,593,865,12,1417,12,1458,3893,6159,2299,161,9712,10052,515,731,1246
2012/2013,2013,08001,Reggio Calabria,626,505,39,1074,8,1131,4219,4295,1655,696,7694,8514,519,462,981
2012/2013,2013,08003,Reggio Calabria - Dante Alighieri,22,101,NA,117,11,123,114,577,273,NA,672,691,22,94,116
2012/2013,2013,08201,Palermo,2797,3726,20,6452,43,6523,18581,27785,10870,131,45828,46366,3281,5372,8653
2012/2013,2013,08301,Messina,1578,2593,886,3205,54,4171,10583,18401,6950,7576,21052,28984,1690,3146,4836
2012/2013,2013,08601,Enna,468,601,NA,1062,12,1069,2483,3509,1675,NA,5945,5992,321,655,976
2012/2013,2013,08701,Catania,2476,3383,NA,5831,41,5859,20294,32297,8991,NA,52006,52591,2612,4488,7100
2012/2013,2013,09001,Sassari,723,1265,NA,1923,27,1988,4908,9076,3290,NA,13677,13984,685,1400,2085
2012/2013,2013,09201,Cagliari,1646,2123,11,3720,38,3769,11420,17553,6121,105,28583,28973,1557,2762,4319
2011/2012,2012,00101,Torino,4077,6707,960,9595,764,10784,25125,41146,17498,7650,57451,66271,4053,7314,11367
2011/2012,2012,00102,Torino Politecnico,3879,1565,2193,3021,943,5444,19881,7766,9414,10109,16669,27647,3684,1648,5332
2011/2012,2012,00201,Piemonte Orientale,759,1056,279,1377,104,1815,3894,5873,2972,1444,7996,9767,515,937,1452
2011/2012,2012,00401,Scienze Gastronomiche,22,38,22,NA,24,60,125,129,85,67,NA,254,38,30,68
2011/2012,2012,00701,Aosta,57,134,13,151,19,191,308,908,270,218,897,1216,42,115,157
2011/2012,2012,01001,Genova,2746,3274,602,5114,493,6020,15768,20353,9830,5111,30011,36121,2497,3666,6163
2011/2012,2012,01201,LIUC,164,106,15,176,2,270,1208,628,585,126,1263,1836,357,162,519
2011/2012,2012,01202,Insubria,728,977,79,1541,100,1705,3947,5059,2355,422,8261,9006,665,1015,1680
2011/2012,2012,01301,Novedrate,452,359,320,167,65,811,3862,2889,3227,4415,1333,6751,321,209,530
2011/2012,2012,01501,Milano,4594,6618,1487,9413,541,11212,24786,35546,17499,9249,50628,60332,3803,6361,10164
2011/2012,2012,01502,Milano Politecnico,4818,2252,1706,5003,416,7070,25766,12954,12875,10533,27827,38720,5565,3344,8909
2011/2012,2012,01503,Milano Bocconi,1231,1261,1565,743,255,2492,6856,6446,4471,9120,4091,13302,2188,2079,4267
2011/2012,2012,01504,Milano Cattolica,2625,4775,2119,4798,416,7400,13341,24682,11290,13362,24021,38023,2920,6325,9245
2011/2012,2012,01505,IULM,265,704,113,564,40,969,1344,3042,1451,1015,2569,4386,266,791,1057
2011/2012,2012,01508,Milano San Raffaele,176,217,34,138,23,393,799,1171,644,154,1212,1970,162,371,533
2011/2012,2012,01509,Milano Bicocca,2531,4045,500,5782,357,6576,12134,20315,9595,3121,28559,32449,1944,3621,5565
2011/2012,2012,01601,Bergamo,1013,1715,26,2620,158,2728,5642,9210,4024,89,14244,14852,917,1627,2544
2011/2012,2012,01701,Brescia,1395,1268,54,2486,199,2663,7568,6751,4381,429,13377,14319,1235,1181,2416
2011/2012,2012,01801,Pavia,1722,2099,1048,2559,234,3821,9746,12193,5943,6643,14906,21939,1784,2327,4111
2011/2012,2012,02101,Bolzano,135,184,99,179,75,319,846,1984,442,780,1804,2830,150,493,643
2011/2012,2012,02201,Trento,1570,1592,1550,1401,177,3162,8152,8619,4790,7943,8175,16771,1394,1525,2919
2011/2012,2012,02301,Verona,1406,2861,1232,2869,259,4267,7964,14976,6176,6307,16290,22940,1383,2975,4358
2011/2012,2012,02701,Ca Foscari,1180,2322,285,2878,172,3502,6421,11892,5569,2283,14841,18313,1226,2588,3814
2011/2012,2012,02702,IUAV,382,390,101,538,32,772,2900,2732,1425,1000,4142,5632,858,917,1775
2011/2012,2012,02801,Padova,4613,5637,1013,8843,390,10250,26669,34008,16224,8698,50849,60677,5025,7105,12130
2011/2012,2012,03001,Udine,1351,1651,630,2245,204,3002,7415,8615,4718,3718,11796,16030,1268,1661,2929
2011/2012,2012,03201,Trieste,1217,1652,780,1811,241,2869,8052,10798,4507,5309,11964,18850,1368,2134,3502
2011/2012,2012,03401,Parma,1748,2131,1425,2267,286,3879,12652,16199,6983,12309,15644,28851,2190,2990,5180
2011/2012,2012,03601,Modena e Reggio Emilia,1843,2037,336,3214,298,3880,8851,10538,5962,2488,15310,19389,1480,2049,3529
2011/2012,2012,03701,Bologna,6042,7729,4605,8512,992,13771,34862,45213,21403,31794,48237,80075,6224,8987,15211
2011/2012,2012,03801,Ferrara,1152,1338,1168,1126,129,2490,7744,9776,4177,8943,7659,17520,1181,1576,2757
2011/2012,2012,04101,Carlo Bo,949,1599,892,1444,161,2548,5723,9320,4054,6869,7528,15043,855,1797,2652
2011/2012,2012,04201,Marche,1539,1060,425,2080,87,2599,9202,7031,4128,2918,12973,16233,1686,1496,3182
2011/2012,2012,04301,Macerata,402,1008,106,1191,86,1410,3229,7778,2677,1443,8507,11007,458,1358,1816
2011/2012,2012,04302,Camerino,474,601,175,677,86,1075,3816,3780,1692,2244,3926,7596,562,578,1140
2011/2012,2012,04801,Firenze,3391,4572,806,6803,589,7963,22377,31603,13805,8784,44165,53980,3830,5492,9322
2011/2012,2012,04804,IUL,2,8,NA,NA,NA,10,6,21,11,NA,NA,27,2,7,9
2011/2012,2012,05001,Pisa,3343,3707,1794,4950,267,7050,21982,24243,11623,13295,32066,46225,3198,3485,6683
2011/2012,2012,05201,Siena,1546,2356,2049,1617,159,3902,7225,10581,5763,7560,9589,17806,1178,1928,3106
2011/2012,2012,05202,Siena Stranieri,43,191,36,122,40,234,126,650,315,105,458,776,10,91,101
2011/2012,2012,05401,Perugia,1934,2370,1107,2887,247,4304,11264,14692,7602,8606,16840,25956,1897,2756,4653
2011/2012,2012,05403,Perugia Stranieri,61,126,48,115,64,187,474,826,383,361,494,1300,137,210,347
2011/2012,2012,05601,Tuscia,722,709,168,1092,31,1431,4315,3696,2272,1838,5547,8011,1016,656,1672
2011/2012,2012,05801,La Sapienza,6719,9184,3091,12494,921,15903,47055,68695,28246,26790,87346,115750,7408,12270,19678
2011/2012,2012,05802,Tor Vergata,2754,2717,772,4553,299,5471,15193,16619,10113,5727,25113,31812,2341,2932,5273
2011/2012,2012,05803,Roma LUMSA,287,655,292,507,44,942,2152,4469,1800,2645,3581,6621,392,981,1373
2011/2012,2012,05805,Roma LUISS,672,645,515,630,20,1317,3696,4103,2291,4024,3321,7799,1048,1077,2125
2011/2012,2012,05806,Roma Foro Italico,226,98,NA,264,1,324,1434,683,604,NA,1695,2117,219,135,354
2011/2012,2012,05807,Roma Tre,2579,3537,655,5335,298,6116,15021,22040,10343,5364,31279,37061,2191,3398,5589
2011/2012,2012,05808,Campus Biomedico,110,155,22,142,2,265,599,862,436,255,756,1461,119,189,308
2011/2012,2012,05809,Roma UNINT,44,98,NA,99,NA,142,430,848,445,NA,685,1278,108,240,348
2011/2012,2012,05810,Roma Marconi,300,247,171,102,11,547,7144,3449,2512,5862,2189,10593,939,473,1412
2011/2012,2012,05811,Unitelma,112,112,24,64,1,224,944,727,867,311,657,1671,149,95,244
2011/2012,2012,05812,Roma Europea,66,107,NA,144,1,173,359,550,281,NA,705,909,60,109,169
2011/2012,2012,05813,Uninettuno,1014,678,847,575,59,1692,3640,2277,2543,3886,1733,5917,84,76,160
2011/2012,2012,05814,Mercatorum,25,11,NA,11,1,36,144,69,106,NA,80,213,10,7,17
2011/2012,2012,05815,Unicusano,563,298,413,209,18,861,6539,3526,3564,6253,2334,10065,1053,579,1632
2011/2012,2012,05816,Roma San Raffaele,79,41,NA,20,1,120,285,154,251,NA,81,439,3,2,5
2011/2012,2012,06001,Cassino,659,738,346,1033,17,1397,4497,5665,2615,2562,7405,10162,633,954,1587
2011/2012,2012,06201,Sannio,536,533,29,1026,7,1069,3247,3490,1433,134,6500,6737,400,452,852
2011/2012,2012,06202,Benevento - Giustino Fortunato,9,3,NA,NA,NA,12,327,161,170,NA,NA,488,79,31,110
2011/2012,2012,06301,Napoli Federico II,6185,7538,300,13284,71,13723,38015,49576,21552,3044,83526,87591,5563,7312,12875
2011/2012,2012,06302,Napoli Parthenope,1463,1057,NA,2455,17,2520,9071,7298,5052,NA,15606,16369,1123,912,2035
2011/2012,2012,06303,Napoli L'Orientale,366,1385,65,1598,61,1751,2228,8006,2738,463,9208,10234,351,1401,1752
2011/2012,2012,06304,Benincasa,185,1089,11,1220,11,1274,1469,8322,2467,103,9439,9791,287,1620,1907
2011/2012,2012,06306,Napoli II,1542,2123,22,3547,7,3665,12160,16820,7004,290,28186,28980,1762,2760,4522
2011/2012,2012,06307,Napoli Pegaso,159,171,48,184,NA,330,2269,1416,1127,670,2218,3685,1316,491,1807
2011/2012,2012,06501,Salerno,2235,3074,200,5037,33,5309,14217,22627,7731,1651,34622,36844,1679,2849,4528
2011/2012,2012,06601,Aquila,1431,1756,1342,1688,81,3187,10842,13219,6557,9154,14046,24061,1386,1744,3130
2011/2012,2012,06701,Teramo,375,544,114,713,29,919,3318,4538,1729,1569,5700,7856,441,541,982
2011/2012,2012,06901,Chieti e Pescara,1620,3042,1949,2492,84,4662,11147,20653,8361,13254,17744,31800,1580,3572,5152
2011/2012,2012,06902,Torrevecchia Teatina,11,22,NA,NA,1,33,144,206,84,NA,NA,350,23,36,59
2011/2012,2012,07001,Molise,517,675,386,733,9,1192,3173,4599,2151,3112,4357,7772,468,760,1228
2011/2012,2012,07101,Foggia,628,1019,102,1509,25,1647,3854,6618,2733,707,9562,10472,502,899,1401
2011/2012,2012,07201,Bari,3354,5616,489,8326,147,8970,19187,35692,12871,3290,50723,54879,2497,5393,7890
2011/2012,2012,07202,Bari Politecnico,1035,383,47,1351,13,1418,8161,3656,2135,435,11199,11817,1171,543,1714
2011/2012,2012,07203,Jean Monnet,104,52,NA,101,1,156,812,480,296,NA,1053,1292,120,103,223
2011/2012,2012,07501,Salento,1097,1896,39,2903,27,2993,7578,14558,4847,350,21449,22136,1126,2693,3819
2011/2012,2012,07601,Basilicata,533,543,142,878,7,1076,3704,4674,1659,1538,6699,8378,358,580,938
2011/2012,2012,07801,Calabria,1736,2506,63,4141,46,4242,13297,19583,6570,541,31982,32880,1801,2931,4732
2011/2012,2012,07901,Catanzaro,553,791,NA,1309,19,1344,3912,6274,2030,NA,9905,10186,484,869,1353
2011/2012,2012,08001,Reggio Calabria,713,599,68,1195,13,1312,4662,4677,1868,831,8352,9339,515,466,981
2011/2012,2012,08003,Reggio Calabria - Dante Alighieri,13,89,NA,94,13,102,80,447,235,NA,509,527,16,51,67
2011/2012,2012,08201,Palermo,2964,4043,24,6932,55,7007,19773,29593,11215,122,48760,49366,3017,5036,8053
2011/2012,2012,08301,Messina,1630,2786,1021,3357,51,4416,11433,19715,7064,8281,22458,31148,1703,3107,4810
2011/2012,2012,08601,Enna,515,646,NA,1155,6,1161,2521,3631,1781,NA,6098,6152,292,670,962
2011/2012,2012,08701,Catania,2501,3669,NA,6122,31,6170,20854,33117,9630,NA,53344,53971,2910,4807,7717
2011/2012,2012,09001,Sassari,689,1243,NA,1859,32,1932,5077,9516,3349,NA,14284,14593,713,1498,2211
2011/2012,2012,09201,Cagliari,1561,2311,17,3797,40,3872,12015,18889,6252,102,30498,30904,1695,3130,4825
2010/2011,2011,00101,Torino,4235,6892,803,10022,739,11127,25079,41486,17539,6588,58447,66565,4047,7008,11055
2010/2011,2011,00102,Torino Politecnico,3289,1311,1528,2853,636,4600,18748,7390,7683,8494,16902,26138,3361,1579,4940
2010/2011,2011,00201,Piemonte Orientale,676,1073,171,1408,114,1749,3747,5939,2821,1090,8094,9686,515,1064,1579
2010/2011,2011,00401,Scienze Gastronomiche,35,32,28,NA,30,67,140,109,88,61,NA,249,28,33,61
2010/2011,2011,00701,Aosta,53,169,18,157,24,222,305,939,343,209,932,1244,36,132,168
2010/2011,2011,01001,Genova,2716,3473,695,5222,534,6189,16051,21025,10269,4993,30946,37076,2541,3375,5916
2010/2011,2011,01201,LIUC,171,92,13,179,5,263,1221,610,538,118,1278,1831,340,191,531
2010/2011,2011,01202,Insubria,760,918,73,1538,109,1678,4162,5215,2293,438,8617,9377,612,903,1515
2010/2011,2011,01301,Novedrate,504,362,389,167,40,866,3726,2485,3321,3781,1268,6211,183,142,325
2010/2011,2011,01501,Milano,4673,6959,1465,9871,535,11632,24947,35511,17630,9145,51035,60458,3715,5911,9626
2010/2011,2011,01502,Milano Politecnico,4606,2209,1576,4863,451,6815,25559,12700,12344,9914,28062,38259,5654,3279,8933
2010/2011,2011,01503,Milano Bocconi,1282,1349,1687,782,308,2631,6937,6335,4648,8890,4224,13272,2171,1912,4083
2010/2011,2011,01504,Milano Cattolica,2591,4672,2205,4575,413,7263,13650,25461,11175,13616,25302,39111,2807,6005,8812
2010/2011,2011,01505,IULM,226,665,114,518,46,891,1348,3110,1399,850,2653,4458,295,723,1018
2010/2011,2011,01508,Milano San Raffaele,147,209,NA,184,11,356,743,1209,600,NA,1281,1952,183,373,556
2010/2011,2011,01509,Milano Bicocca,2570,4132,427,5984,375,6702,11961,19763,9726,2875,28094,31724,1903,3604,5507
2010/2011,2011,01601,Bergamo,1039,1715,25,2654,181,2754,5759,9276,4074,68,14474,15035,929,1606,2535
2010/2011,2011,01701,Brescia,1355,1199,46,2407,185,2554,7747,6688,4506,395,13522,14435,1184,1185,2369
2010/2011,2011,01801,Pavia,1766,2267,1140,2658,234,4033,10055,12552,6818,6318,15692,22607,1741,2452,4193
2010/2011,2011,02101,Bolzano,209,442,181,420,127,651,890,2299,853,833,2088,3189,158,472,630
2010/2011,2011,02201,Trento,1468,1631,1447,1431,174,3099,7937,8486,5279,7276,8445,16423,1218,1445,2663
2010/2011,2011,02301,Verona,1747,3210,1284,3464,293,4957,8259,15428,6886,6396,16912,23687,1266,2765,4031
2010/2011,2011,02701,Ca Foscari,1047,1984,243,2503,166,3031,6455,11510,4989,2072,14765,17965,1124,2437,3561
2010/2011,2011,02702,IUAV,421,490,137,660,49,911,3119,2917,1740,974,4521,6036,731,783,1514
2010/2011,2011,02801,Padova,4733,5607,942,9010,433,10340,27106,34455,16322,8458,51786,61561,4933,6723,11656
2010/2011,2011,03001,Udine,1292,1561,601,2141,212,2853,7758,8816,5640,3800,12161,16574,1237,1703,2940
2010/2011,2011,03201,Trieste,1183,1687,831,1791,245,2870,8290,11057,4453,5430,12396,19347,1315,1917,3232
2010/2011,2011,03401,Parma,2258,2910,2049,2900,359,5168,13411,17170,8111,13273,16527,30581,2050,2669,4719
2010/2011,2011,03601,Modena e Reggio Emilia,1676,1874,247,2996,217,3550,8855,10616,5617,2727,15326,19471,1560,2083,3643
2010/2011,2011,03701,Bologna,5741,7265,4106,8235,912,13006,34923,45138,20406,31437,48573,80061,6039,9111,15150
2010/2011,2011,03801,Ferrara,1237,1751,1528,1275,131,2988,7984,10024,4514,9492,8031,18008,1307,1632,2939
2010/2011,2011,04101,Carlo Bo,866,1405,767,1288,184,2271,5687,9451,3763,6218,7622,15138,903,1863,2766
2010/2011,2011,04201,Marche,1542,1161,450,2151,143,2703,9345,7271,4188,2952,13294,16616,1431,1423,2854
2010/2011,2011,04301,Macerata,425,1043,154,1168,74,1468,3486,8120,2856,1603,8952,11606,432,1389,1821
2010/2011,2011,04302,Camerino,450,536,128,646,66,986,3965,3809,1709,1887,3961,7774,531,488,1019
2010/2011,2011,04801,Firenze,3599,5018,1175,7143,600,8617,23598,32886,15037,10223,45588,56484,3924,5376,9300
2010/2011,2011,05001,Pisa,3369,3569,1619,4978,249,6938,22258,24330,11899,12994,32534,46588,3243,3520,6763
2010/2011,2011,05201,Siena,1115,1696,1048,1521,142,2811,7219,10381,4716,6430,10192,17600,1334,2032,3366
2010/2011,2011,05202,Siena Stranieri,37,135,10,87,35,172,122,559,232,65,409,681,19,118,137
2010/2011,2011,05401,Perugia,1964,2489,1186,2982,238,4453,11958,15649,8220,9354,17746,27607,2053,2938,4991
2010/2011,2011,05403,Perugia Stranieri,71,101,69,68,87,172,601,875,351,393,487,1476,153,236,389
2010/2011,2011,05601,Tuscia,945,634,338,1019,30,1579,5103,3868,1978,2231,5901,8971,1083,670,1753
2010/2011,2011,05801,La Sapienza,7066,9414,3306,12891,898,16480,49932,72915,31734,28466,92738,122847,7471,12620,20091
2010/2011,2011,05802,Tor Vergata,2630,2777,593,4622,328,5407,14951,16957,9725,5039,25849,31908,2411,2886,5297
2010/2011,2011,05803,Roma LUMSA,313,660,315,505,57,973,2225,4513,2100,2636,3684,6738,375,1031,1406
2010/2011,2011,05805,Roma LUISS,591,735,556,613,23,1326,3577,4142,2251,4025,3245,7719,972,1090,2062
2010/2011,2011,05806,Roma Foro Italico,250,88,NA,276,5,338,1349,634,592,NA,1566,1983,176,86,262
2010/2011,2011,05807,Roma Tre,2705,3419,747,5254,250,6124,15543,22471,10360,5214,32291,38014,2067,3142,5209
2010/2011,2011,05808,Campus Biomedico,107,170,NA,172,5,277,559,779,484,NA,690,1338,101,132,233
2010/2011,2011,05809,Roma UNINT,55,131,24,108,6,186,504,851,447,280,707,1355,141,216,357
2010/2011,2011,05810,Roma Marconi,759,364,530,266,12,1123,7142,3029,3311,7250,2067,10171,965,387,1352
2010/2011,2011,05811,Unitelma,122,91,37,71,1,213,785,585,812,421,536,1370,138,99,237
2010/2011,2011,05812,Roma Europea,44,76,NA,89,NA,120,338,500,233,NA,640,838,65,109,174
2010/2011,2011,05813,Uninettuno,1317,811,1070,751,22,2128,3203,2014,3527,3506,1495,5217,59,44,103
2010/2011,2011,05814,Mercatorum,38,23,NA,17,NA,61,146,86,152,NA,77,232,11,12,23
2010/2011,2011,05815,Unicusano,866,405,643,376,8,1271,6202,3015,4446,6388,2304,9217,1246,482,1728
2010/2011,2011,05816,Roma San Raffaele,70,47,13,13,6,117,205,121,205,36,36,326,7,NA,NA
2010/2011,2011,06001,Cassino,720,768,336,1123,27,1488,4675,6008,2708,2563,7882,10683,599,892,1491
2010/2011,2011,06201,Sannio,556,623,11,1140,9,1179,3416,3660,1561,80,6821,7076,359,406,765
2010/2011,2011,06202,Benevento - Giustino Fortunato,35,14,11,10,NA,49,382,175,265,87,328,557,58,35,93
2010/2011,2011,06301,Napoli Federico II,6278,7391,320,13239,87,13669,38434,49727,22239,3312,83913,88161,5188,6881,12069
2010/2011,2011,06302,Napoli Parthenope,1691,1635,48,3212,22,3326,9705,7726,5257,441,16487,17431,1070,927,1997
2010/2011,2011,06303,Napoli L'Orientale,334,1188,39,1391,64,1522,2346,8185,2604,367,9414,10531,363,1442,1805
2010/2011,2011,06304,Benincasa,211,1169,12,1331,7,1380,1650,8821,3154,111,10103,10471,287,1573,1860
2010/2011,2011,06306,Napoli II,1721,2172,11,3823,12,3893,12653,17161,7269,296,28982,29814,1806,2541,4347
2010/2011,2011,06307,Napoli Pegaso,437,330,178,402,1,767,4173,1750,3440,1726,2854,5923,1427,504,1931
2010/2011,2011,06501,Salerno,2312,2927,176,5018,34,5239,14584,22789,8011,1664,35109,37373,1656,2738,4394
2010/2011,2011,06601,Aquila,1700,1615,1459,1621,95,3315,10680,12813,6415,8396,14349,23493,1239,1992,3231
2010/2011,2011,06701,Teramo,399,533,119,721,24,932,3603,4700,1925,1550,6076,8303,593,486,1079
2010/2011,2011,06901,Chieti e Pescara,2182,3988,2960,2953,136,6170,11550,20851,10212,13714,18357,32401,1689,3576,5265
2010/2011,2011,06902,Torrevecchia Teatina,10,18,NA,NA,NA,28,157,222,101,NA,NA,379,25,38,63
2010/2011,2011,07001,Molise,546,674,356,753,12,1220,3405,4669,2112,3139,4734,8074,624,1050,1674
2010/2011,2011,07101,Foggia,681,1058,98,1596,26,1739,4054,6914,2845,731,10012,10968,473,984,1457
2010/2011,2011,07201,Bari,3432,5745,446,8588,141,9177,20134,37392,14068,3384,53214,57526,2428,5207,7635
2010/2011,2011,07202,Bari Politecnico,1310,501,75,1705,10,1811,8620,3804,2623,443,11775,12424,1088,463,1551
2010/2011,2011,07203,Jean Monnet,145,84,58,114,NA,229,826,520,503,106,1066,1346,134,85,219
2010/2011,2011,07501,Salento,1345,2076,50,3325,29,3421,8153,15738,5354,362,23159,23891,1111,2849,3960
2010/2011,2011,07601,Basilicata,494,583,154,869,4,1077,3723,4783,1758,1521,6840,8506,403,554,957
2010/2011,2011,07801,Calabria,1744,2611,76,4229,53,4355,13896,20262,6979,508,33287,34158,1794,2974,4768
2010/2011,2011,07901,Catanzaro,581,865,NA,1417,25,1446,4267,6704,2185,NA,10679,10971,614,989,1603
2010/2011,2011,08001,Reggio Calabria,734,648,67,1300,13,1382,4924,4908,2289,912,8763,9832,533,481,1014
2010/2011,2011,08003,Reggio Calabria - Dante Alighieri,8,54,NA,62,8,62,71,285,215,NA,349,356,6,23,29
2010/2011,2011,08201,Palermo,3307,4335,21,7547,73,7642,21281,31625,11880,93,52227,52906,2729,4700,7429
2010/2011,2011,08301,Messina,1813,2958,1158,3530,70,4771,11950,20499,7701,8826,23168,32449,1623,3003,4626
2010/2011,2011,08601,Enna,568,757,NA,1310,3,1325,2500,3729,1958,NA,6149,6229,269,588,857
2010/2011,2011,08701,Catania,2570,3654,NA,6151,37,6224,22413,35349,11132,NA,57031,57762,2735,4459,7194
2010/2011,2011,09001,Sassari,729,1287,20,1942,42,2016,5248,9963,3443,59,14929,15211,732,1691,2423
2010/2011,2011,09201,Cagliari,1696,2372,14,4002,34,4068,12721,20262,6687,96,32555,32983,1568,2851,4419
2014/2015,NA,01510,Humanitas University,25,40,13,24,16,65,47,94,141,12,73,141,NA,NA,NA
2018/2019,NA,05818,Roma Saint Camillus,34,63,41,14,63,97,75,132,207,36,49,207,NA,NA,NA
2019/2020,NA,00101,Torino,5352,8313,2063,11255,929,13665,29103,45915,22152,15642,58001,75018,NA,NA,NA
2019/2020,NA,00102,Torino Politecnico,3620,1501,2110,2795,630,5121,23128,9351,10831,16579,14946,32479,NA,NA,NA
2019/2020,NA,00201,Piemonte Orientale,1350,2167,889,2389,230,3517,5175,7947,4297,3538,9239,13122,NA,NA,NA
2019/2020,NA,00401,Scienze Gastronomiche,40,53,30,13,31,93,192,180,132,92,123,372,NA,NA,NA
2019/2020,NA,00701,Aosta,68,159,65,127,21,227,317,702,312,254,618,1019,NA,NA,NA
2019/2020,NA,01001,Genova,2610,3225,599,4934,607,5835,13574,16962,9136,4585,25101,30536,NA,NA,NA
2019/2020,NA,01201,LIUC,260,130,21,258,13,390,1609,877,1010,232,1572,2486,NA,NA,NA
2019/2020,NA,01202,Insubria,1481,1648,152,2847,191,3129,5252,6137,3801,573,10432,11389,NA,NA,NA
2019/2020,NA,01301,Novedrate,1688,1571,2452,667,206,3259,10418,11431,8408,18269,3471,21849,NA,NA,NA
2019/2020,NA,01501,Milano,4904,7598,1922,10262,845,12502,25152,35908,19747,12521,48483,61060,NA,NA,NA
2019/2020,NA,01502,Milano Politecnico,5145,2554,2574,4778,385,7699,30139,15293,15066,19366,25993,45432,NA,NA,NA
2019/2020,NA,01503,Milano Bocconi,1688,1076,1729,834,552,2764,7958,5627,4792,9442,4014,13585,NA,NA,NA
2019/2020,NA,01504,Milano Cattolica,2717,5519,2522,5135,538,8236,13921,27329,13402,17274,23863,41250,NA,NA,NA
2019/2020,NA,01505,IULM,426,1265,412,983,86,1691,1874,4910,2502,2150,3890,6784,NA,NA,NA
2019/2020,NA,01508,Milano San Raffaele,202,302,114,168,37,504,1125,1837,864,734,1391,2962,NA,NA,NA
2019/2020,NA,01509,Milano Bicocca,2204,3148,378,4583,261,5352,13213,20399,10020,3707,28105,33612,NA,NA,NA
2019/2020,NA,01510,Humanitas University,111,184,96,95,103,295,420,751,331,247,597,1171,NA,NA,NA
2019/2020,NA,01601,Bergamo,1986,3422,100,5131,327,5408,7875,13216,7088,554,19492,21091,NA,NA,NA
2019/2020,NA,01701,Brescia,1798,1454,128,3038,227,3252,7824,6590,4375,662,13420,14414,NA,NA,NA
2019/2020,NA,01801,Pavia,2009,2381,1062,3078,428,4390,10309,12986,7276,7526,14806,23295,NA,NA,NA
2019/2020,NA,02101,Bolzano,225,514,257,373,68,739,1217,2739,1103,1458,2053,3956,NA,NA,NA
2019/2020,NA,02201,Trento,1511,1589,1756,1103,80,3100,8233,8550,4904,10193,5834,16783,NA,NA,NA
2019/2020,NA,02301,Verona,1363,2572,1117,2623,158,3935,7948,14487,6819,6509,14850,22435,NA,NA,NA
2019/2020,NA,02701,Ca Foscari,1404,2485,575,2991,241,3889,7562,13516,6738,5029,15234,21078,NA,NA,NA
2019/2020,NA,02702,IUAV,260,390,80,479,45,650,1686,2119,1269,527,2497,3805,NA,NA,NA
2019/2020,NA,02801,Padova,5436,5904,1610,9305,496,11340,28210,31606,18232,12949,46434,59816,NA,NA,NA
2019/2020,NA,03001,Udine,1510,1599,621,2363,159,3109,7121,7729,4604,3283,10831,14850,NA,NA,NA
2019/2020,NA,03201,Trieste,1058,1686,710,1747,132,2744,6602,8853,4331,4618,9130,15455,NA,NA,NA
2019/2020,NA,03401,Parma,2265,3122,2107,2999,363,5387,11283,15385,8419,12648,13710,26668,NA,NA,NA
2019/2020,NA,03601,Modena e Reggio Emilia,2752,3000,958,4246,280,5752,12558,14106,8971,7311,18478,26664,NA,NA,NA
2019/2020,NA,03701,Bologna,6277,7977,5252,8312,1346,14254,35389,44446,24064,37563,42272,79835,NA,NA,NA
2019/2020,NA,03801,Ferrara,2555,4214,4232,2302,266,6769,9303,13456,8437,14264,8369,22759,NA,NA,NA
2019/2020,NA,04101,Carlo Bo,1157,1775,1245,1488,133,2932,5465,9037,4327,7018,7141,14502,NA,NA,NA
2019/2020,NA,04201,Marche,1609,1313,596,2173,128,2922,8264,6747,4498,3572,10960,15011,NA,NA,NA
2019/2020,NA,04301,Macerata,448,1244,273,1327,76,1692,2622,7351,3462,1615,7482,9973,NA,NA,NA
2019/2020,NA,04302,Camerino,560,524,160,696,102,1084,3202,3091,1562,1532,3533,6293,NA,NA,NA
2019/2020,NA,04801,Firenze,3852,5049,1319,7370,637,8901,22073,29846,14834,11789,39725,51919,NA,NA,NA
2019/2020,NA,05001,Pisa,3575,3640,1610,5323,331,7215,21546,22737,13055,14121,29925,44283,NA,NA,NA
2019/2020,NA,05201,Siena,947,1534,663,1522,166,2481,6104,9359,4222,6099,7933,15463,NA,NA,NA
2019/2020,NA,05202,Siena Stranieri,86,410,102,256,56,496,369,1801,670,622,1143,2170,NA,NA,NA
2019/2020,NA,05401,Perugia,1827,2592,908,3178,322,4419,9914,13592,7059,7146,15575,23506,NA,NA,NA
2019/2020,NA,05403,Perugia Stranieri,60,87,47,81,66,147,380,714,413,224,553,1094,NA,NA,NA
2019/2020,NA,05601,Tuscia,754,760,144,1195,46,1514,3846,4026,2462,1234,6020,7872,NA,NA,NA
2019/2020,NA,05801,La Sapienza,7182,9940,2442,14294,1083,17122,44077,59584,29839,18510,83894,103661,NA,NA,NA
2019/2020,NA,05802,Tor Vergata,2365,2517,492,4177,440,4882,12517,14190,8553,4511,21295,26707,NA,NA,NA
2019/2020,NA,05803,Roma LUMSA,350,721,248,667,39,1071,1892,4254,1943,2089,3371,6146,NA,NA,NA
2019/2020,NA,05805,Roma LUISS,865,801,563,852,66,1666,5154,4312,3158,3902,4551,9466,NA,NA,NA
2019/2020,NA,05806,Roma Foro Italico,275,87,NA,304,3,362,1520,567,683,NA,1653,2087,NA,NA,NA
2019/2020,NA,05807,Roma Tre,2438,3238,358,5041,354,5676,12481,18307,8675,3007,26633,30788,NA,NA,NA
2019/2020,NA,05808,Campus Biomedico,158,258,74,216,5,416,786,1232,1274,407,1137,2018,NA,NA,NA
2019/2020,NA,05809,Roma UNINT,33,113,NA,97,7,146,352,1416,777,NA,1053,1768,NA,NA,NA
2019/2020,NA,05810,Roma Marconi,378,377,335,147,31,755,4982,5219,3726,6064,2263,10201,NA,NA,NA
2019/2020,NA,05811,Unitelma,194,179,70,100,13,373,1127,1104,1133,637,886,2231,NA,NA,NA
2019/2020,NA,05812,Roma Europea,84,195,12,216,11,279,419,1074,446,134,1168,1493,NA,NA,NA
2019/2020,NA,05813,Uninettuno,843,625,937,200,244,1468,8953,6138,3481,11135,3424,15091,NA,NA,NA
2019/2020,NA,05815,Unicusano,1531,908,1743,466,115,2439,10742,8066,8386,14885,3741,18808,NA,NA,NA
2019/2020,NA,05816,Roma San Raffaele,463,276,236,173,11,739,3770,2932,2832,3636,1576,6702,NA,NA,NA
2019/2020,NA,05817,Link Campus,68,25,NA,49,11,93,618,259,297,NA,427,877,NA,NA,NA
2019/2020,NA,05818,Roma Saint Camillus,93,173,61,84,128,266,196,365,365,79,197,561,NA,NA,NA
2019/2020,NA,06001,Cassino,630,624,417,765,173,1254,3266,3780,2174,2188,4672,7046,NA,NA,NA
2019/2020,NA,06201,Sannio,410,391,34,742,9,801,2074,2227,1094,144,4086,4301,NA,NA,NA
2019/2020,NA,06202,Benevento - Giustino Fortunato,45,58,NA,37,4,103,635,613,750,NA,670,1248,NA,NA,NA
2019/2020,NA,06301,Napoli Federico II,6419,7559,480,13322,124,13978,33154,40883,21904,2888,70380,74037,NA,NA,NA
2019/2020,NA,06302,Napoli Parthenope,1148,805,10,1871,34,1953,6125,4637,3143,74,10354,10762,NA,NA,NA
2019/2020,NA,06303,Napoli L'Orientale,454,1707,130,1886,89,2161,2330,9237,3246,1114,9939,11567,NA,NA,NA
2019/2020,NA,06304,Benincasa,223,1257,13,1432,11,1480,1244,7115,2500,71,7998,8359,NA,NA,NA
2019/2020,NA,06306,Napoli II,1430,1880,70,3156,92,3310,9375,13360,5650,450,21444,22735,NA,NA,NA
2019/2020,NA,06307,Napoli Pegaso,3849,1474,3858,1288,26,5323,30508,23445,24063,38151,15759,53953,NA,NA,NA
2019/2020,NA,06501,Salerno,2853,3173,209,5756,88,6026,15627,19490,9051,1541,33167,35117,NA,NA,NA
2019/2020,NA,06601,Aquila,1045,990,338,1590,64,2035,7118,8689,4194,3747,9934,15807,NA,NA,NA
2019/2020,NA,06701,Teramo,403,546,104,698,18,949,2353,3136,1504,923,3923,5489,NA,NA,NA
2019/2020,NA,06901,Chieti e Pescara,1362,2524,1456,2241,128,3886,8122,14741,6379,9341,12781,22863,NA,NA,NA
2019/2020,NA,07001,Molise,490,620,425,603,11,1110,2808,3913,1786,2935,3581,6721,NA,NA,NA
2019/2020,NA,07101,Foggia,809,1162,87,1796,29,1971,3937,6547,3054,752,9496,10484,NA,NA,NA
2019/2020,NA,07201,Bari,3000,4445,382,6938,138,7445,15725,26465,11002,2622,38888,42190,NA,NA,NA
2019/2020,NA,07202,Bari Politecnico,1310,649,75,1853,28,1959,6820,3051,2742,425,9320,9871,NA,NA,NA
2019/2020,NA,07203,Jean Monnet,152,108,NA,228,2,260,941,650,423,NA,1498,1591,NA,NA,NA
2019/2020,NA,07501,Salento,1456,2157,38,3513,49,3613,6655,10790,5276,227,16993,17445,NA,NA,NA
2019/2020,NA,07601,Basilicata,486,483,185,747,13,969,2680,3591,1408,1513,4710,6271,NA,NA,NA
2019/2020,NA,07801,Calabria,1703,2143,244,3572,158,3846,10153,14105,5667,1318,22758,24258,NA,NA,NA
2019/2020,NA,07901,Catanzaro,699,1063,17,1661,44,1762,4227,6732,2556,48,9964,10959,NA,NA,NA
2019/2020,NA,08001,Reggio Calabria,380,330,30,660,40,710,2329,2535,1182,327,4468,4864,NA,NA,NA
2019/2020,NA,08003,Reggio Calabria - Dante Alighieri,27,68,39,40,54,95,130,566,212,124,513,696,NA,NA,NA
2019/2020,NA,08201,Palermo,3490,4679,40,8063,112,8169,16996,23713,12254,231,40238,40709,NA,NA,NA
2019/2020,NA,08301,Messina,1566,2412,790,3144,103,3978,8338,14248,6375,4982,17315,22586,NA,NA,NA
2019/2020,NA,08601,Enna,322,563,NA,874,9,885,1602,3159,1270,NA,4709,4761,NA,NA,NA
2019/2020,NA,08701,Catania,2726,3337,20,5964,78,6063,16325,21671,9015,203,37609,37996,NA,NA,NA
2019/2020,NA,09001,Sassari,922,1338,11,2173,51,2260,4920,8358,3820,95,12613,13278,NA,NA,NA
2019/2020,NA,09201,Cagliari,1824,2409,10,4184,56,4233,10456,14703,6938,138,24691,25159,NA,NA,NA
2020/2021,NA,00101,Torino,5755,8729,2214,11946,818,14484,31336,50046,NA,NA,NA,81382,NA,NA,NA
2020/2021,NA,00102,Torino Politecnico,3609,1593,2445,2563,823,5202,24049,9994,NA,NA,NA,34043,NA,NA,NA
2020/2021,NA,00201,Piemonte Orientale,1408,2072,988,2309,296,3480,5515,8264,NA,NA,NA,13779,NA,NA,NA
2020/2021,NA,00401,Scienze Gastronomiche,34,36,19,15,19,70,167,156,NA,NA,NA,323,NA,NA,NA
2020/2021,NA,00701,Aosta,78,167,59,130,21,245,312,700,NA,NA,NA,1012,NA,NA,NA
2020/2021,NA,01001,Genova,3176,4095,1170,5624,628,7271,14655,18580,NA,NA,NA,33235,NA,NA,NA
2020/2021,NA,01201,LIUC,308,132,38,284,9,440,1701,920,NA,NA,NA,2621,NA,NA,NA
2020/2021,NA,01202,Insubria,1461,1641,112,2897,161,3102,5502,6489,NA,NA,NA,11991,NA,NA,NA
2020/2021,NA,01301,Novedrate,1941,2044,3067,825,235,3985,9301,10852,NA,NA,NA,20153,NA,NA,NA
2020/2021,NA,01501,Milano,4586,7350,1702,9882,737,11936,25312,37202,NA,NA,NA,62514,NA,NA,NA
2020/2021,NA,01502,Milano Politecnico,5162,2601,2574,4766,459,7763,29789,15275,NA,NA,NA,45064,NA,NA,NA
2020/2021,NA,01503,Milano Bocconi,1655,1173,1814,787,597,2828,7998,5608,NA,NA,NA,13606,NA,NA,NA
2020/2021,NA,01504,Milano Cattolica,2742,5477,2466,5209,582,8219,13633,27432,NA,NA,NA,41065,NA,NA,NA
2020/2021,NA,01505,IULM,434,1350,467,1076,89,1784,1827,5113,NA,NA,NA,6940,NA,NA,NA
2020/2021,NA,01508,Milano San Raffaele,187,330,110,176,70,517,1166,2094,NA,NA,NA,3260,NA,NA,NA
2020/2021,NA,01509,Milano Bicocca,2309,3842,497,5253,316,6151,13561,21779,NA,NA,NA,35340,NA,NA,NA
2020/2021,NA,01510,Humanitas University,81,134,59,91,63,215,445,779,NA,NA,NA,1224,NA,NA,NA
2020/2021,NA,01601,Bergamo,1376,2145,41,3368,181,3521,8199,13720,NA,NA,NA,21919,NA,NA,NA
2020/2021,NA,01701,Brescia,1746,1496,100,3030,201,3242,8027,6966,NA,NA,NA,14993,NA,NA,NA
2020/2021,NA,01801,Pavia,2129,2521,1047,3352,431,4650,10366,13223,NA,NA,NA,23589,NA,NA,NA
2020/2021,NA,02101,Bolzano,202,469,215,349,77,671,1252,2833,NA,NA,NA,4085,NA,NA,NA
2020/2021,NA,02201,Trento,1484,1555,1737,1047,118,3039,7872,8203,NA,NA,NA,16075,NA,NA,NA
2020/2021,NA,02301,Verona,1617,3100,1442,3054,215,4717,8353,14972,NA,NA,NA,23325,NA,NA,NA
2020/2021,NA,02701,Ca Foscari,1368,2316,552,2779,236,3684,7797,13578,NA,NA,NA,21375,NA,NA,NA
2020/2021,NA,02702,IUAV,282,412,70,510,40,694,1650,2149,NA,NA,NA,3799,NA,NA,NA
2020/2021,NA,02801,Padova,5796,6542,1795,10146,538,12338,29946,33934,NA,NA,NA,63880,NA,NA,NA
2020/2021,NA,03001,Udine,1486,1647,615,2362,126,3133,7001,7914,NA,NA,NA,14915,NA,NA,NA
2020/2021,NA,03201,Trieste,1285,1676,769,1917,159,2961,6617,8827,NA,NA,NA,15444,NA,NA,NA
2020/2021,NA,03401,Parma,2362,3326,2052,3343,383,5688,11646,16199,NA,NA,NA,27845,NA,NA,NA
2020/2021,NA,03601,Modena e Reggio Emilia,2611,2720,822,3922,242,5331,13093,14705,NA,NA,NA,27798,NA,NA,NA
2020/2021,NA,03701,Bologna,6180,7872,5455,7973,1275,14052,36037,45598,NA,NA,NA,81635,NA,NA,NA
2020/2021,NA,03801,Ferrara,2727,4580,4288,2750,298,7307,10374,15296,NA,NA,NA,25670,NA,NA,NA
2020/2021,NA,04101,Carlo Bo,1064,1838,1107,1598,168,2902,5389,9365,NA,NA,NA,14754,NA,NA,NA
2020/2021,NA,04201,Marche,1550,1226,564,1976,117,2776,8279,6796,NA,NA,NA,15075,NA,NA,NA
2020/2021,NA,04301,Macerata,437,1202,215,1297,59,1639,2375,6976,NA,NA,NA,9351,NA,NA,NA
2020/2021,NA,04302,Camerino,812,622,315,811,88,1434,3203,2908,NA,NA,NA,6111,NA,NA,NA
2020/2021,NA,04801,Firenze,4295,5787,1395,8469,629,10082,23076,31793,NA,NA,NA,54869,NA,NA,NA
2020/2021,NA,04804,IUL,63,130,46,13,6,193,192,484,NA,NA,NA,676,NA,NA,NA
2020/2021,NA,05001,Pisa,3550,3769,1517,5469,308,7319,22855,24594,NA,NA,NA,47449,NA,NA,NA
2020/2021,NA,05201,Siena,920,1573,569,1596,208,2493,5929,9491,NA,NA,NA,15420,NA,NA,NA
2020/2021,NA,05202,Siena Stranieri,77,365,55,232,48,442,419,2025,NA,NA,NA,2444,NA,NA,NA
2020/2021,NA,05401,Perugia,2470,3688,2116,3679,325,6158,10721,15372,NA,NA,NA,26093,NA,NA,NA
2020/2021,NA,05403,Perugia Stranieri,65,109,49,84,67,174,358,742,NA,NA,NA,1100,NA,NA,NA
2020/2021,NA,05601,Tuscia,767,839,194,1239,71,1606,3803,4095,NA,NA,NA,7898,NA,NA,NA
2020/2021,NA,05801,La Sapienza,7604,10776,3251,14787,1222,18380,45007,62254,NA,NA,NA,107261,NA,NA,NA
2020/2021,NA,05802,Tor Vergata,2554,2734,620,4489,419,5288,11973,13821,NA,NA,NA,25794,NA,NA,NA
2020/2021,NA,05803,Roma LUMSA,338,721,205,672,39,1059,1841,4376,NA,NA,NA,6217,NA,NA,NA
2020/2021,NA,05805,Roma LUISS,989,858,583,990,79,1847,5048,4456,NA,NA,NA,9504,NA,NA,NA
2020/2021,NA,05806,Roma Foro Italico,346,109,12,387,8,455,1566,606,NA,NA,NA,2172,NA,NA,NA
2020/2021,NA,05807,Roma Tre,2886,3749,515,5819,440,6635,12622,18786,NA,NA,NA,31408,NA,NA,NA
2020/2021,NA,05808,Campus Biomedico,167,233,58,226,10,400,820,1297,NA,NA,NA,2117,NA,NA,NA
2020/2021,NA,05809,Roma UNINT,37,118,NA,88,5,155,369,1580,NA,NA,NA,1949,NA,NA,NA
2020/2021,NA,05810,Roma Marconi,200,291,135,75,20,491,2874,3349,NA,NA,NA,6223,NA,NA,NA
2020/2021,NA,05811,Unitelma,82,53,NA,37,9,135,799,803,NA,NA,NA,1602,NA,NA,NA
2020/2021,NA,05812,Roma Europea,92,196,33,177,10,288,478,1231,NA,NA,NA,1709,NA,NA,NA
2020/2021,NA,05813,Uninettuno,770,786,1066,200,99,1556,2815,2525,NA,NA,NA,5340,NA,NA,NA
2020/2021,NA,05815,Unicusano,1084,859,1238,388,104,1943,2401,2204,NA,NA,NA,4605,NA,NA,NA
2020/2021,NA,05816,Roma San Raffaele,482,341,376,165,22,823,4162,3606,NA,NA,NA,7768,NA,NA,NA
2020/2021,NA,05817,Link Campus,66,21,NA,37,5,87,396,159,NA,NA,NA,555,NA,NA,NA
2020/2021,NA,05818,Roma Saint Camillus,184,295,211,105,193,479,410,703,NA,NA,NA,1113,NA,NA,NA
2020/2021,NA,06001,Cassino,560,654,412,747,188,1214,3149,3636,NA,NA,NA,6785,NA,NA,NA
2020/2021,NA,06201,Sannio,411,422,22,774,6,833,2007,2093,NA,NA,NA,4100,NA,NA,NA
2020/2021,NA,06202,Benevento - Giustino Fortunato,68,81,22,42,1,149,525,648,NA,NA,NA,1173,NA,NA,NA
2020/2021,NA,06301,Napoli Federico II,6373,7913,526,13586,141,14286,31790,39614,NA,NA,NA,71404,NA,NA,NA
2020/2021,NA,06302,Napoli Parthenope,1421,905,30,2222,32,2326,6318,4595,NA,NA,NA,10913,NA,NA,NA
2020/2021,NA,06303,Napoli L'Orientale,434,1625,207,1711,76,2059,2289,9159,NA,NA,NA,11448,NA,NA,NA
2020/2021,NA,06304,Benincasa,231,1226,NA,1425,12,1457,1075,6387,NA,NA,NA,7462,NA,NA,NA
2020/2021,NA,06306,Napoli II,1419,2038,71,3247,91,3457,9334,13638,NA,NA,NA,22972,NA,NA,NA
2020/2021,NA,06307,Napoli Pegaso,3882,1618,4265,1122,148,5500,12724,12150,NA,NA,NA,24874,NA,NA,NA
2020/2021,NA,06501,Salerno,2691,3124,153,5600,59,5815,15262,18772,NA,NA,NA,34034,NA,NA,NA
2020/2021,NA,06601,Aquila,864,1045,391,1413,49,1909,6545,8224,NA,NA,NA,14769,NA,NA,NA
2020/2021,NA,06701,Teramo,416,534,112,685,23,950,2482,3286,NA,NA,NA,5768,NA,NA,NA
2020/2021,NA,06901,Chieti e Pescara,1387,2493,1348,2292,118,3880,7962,14575,NA,NA,NA,22537,NA,NA,NA
2020/2021,NA,07001,Molise,476,584,407,579,14,1060,2641,3947,NA,NA,NA,6588,NA,NA,NA
2020/2021,NA,07101,Foggia,999,1606,87,2427,32,2605,4283,7114,NA,NA,NA,11397,NA,NA,NA
2020/2021,NA,07201,Bari,3302,4374,411,7112,136,7676,15803,26040,NA,NA,NA,41843,NA,NA,NA
2020/2021,NA,07202,Bari Politecnico,1344,547,79,1798,20,1891,7314,3146,NA,NA,NA,10460,NA,NA,NA
2020/2021,NA,07203,Jean Monnet,143,79,NA,206,NA,222,865,593,NA,NA,NA,1458,NA,NA,NA
2020/2021,NA,07501,Salento,1596,2321,57,3792,61,3917,6871,11170,NA,NA,NA,18041,NA,NA,NA
2020/2021,NA,07601,Basilicata,437,525,157,774,14,962,2605,3529,NA,NA,NA,6134,NA,NA,NA
2020/2021,NA,07801,Calabria,1809,2316,295,3791,194,4125,10170,14021,NA,NA,NA,24191,NA,NA,NA
2020/2021,NA,07901,Catanzaro,709,957,14,1606,34,1666,4066,6355,NA,NA,NA,10421,NA,NA,NA
2020/2021,NA,08001,Reggio Calabria,362,441,44,738,27,803,2150,2687,NA,NA,NA,4837,NA,NA,NA
2020/2021,NA,08003,Reggio Calabria - Dante Alighieri,6,33,NA,28,11,39,95,478,NA,NA,NA,573,NA,NA,NA
2020/2021,NA,08201,Palermo,3716,4791,12,8393,100,8507,16922,23627,NA,NA,NA,40549,NA,NA,NA
2020/2021,NA,08301,Messina,2018,2830,1123,3650,327,4848,8909,14709,NA,NA,NA,23618,NA,NA,NA
2020/2021,NA,08601,Enna,326,576,14,872,7,902,1574,3309,NA,NA,NA,4883,NA,NA,NA
2020/2021,NA,08701,Catania,3029,4289,35,7187,123,7318,15874,21532,NA,NA,NA,37406,NA,NA,NA
2020/2021,NA,09001,Sassari,940,1425,29,2248,58,2365,4931,8233,NA,NA,NA,13164,NA,NA,NA
2020/2021,NA,09201,Cagliari,1858,2512,33,4302,69,4370,10489,15089,NA,NA,NA,25578,NA,NA,NA
2019/2020,NA,04804,IUL,24,30,NA,NA,NA,54,106,286,215,NA,NA,392,NA,NA,NA
2020/2021,NA,06902,Torrevecchia Teatina,NA,1,NA,NA,NA,NA,9,16,NA,NA,NA,25,NA,NA,NA
